id;gender;yearofstudy;outdegree;indegree;popular;averageChar;dayactive;send.day34th.friends;send.friends
1;1;4;33;25;58;110.210784313725;1;61;34
2;1;1;0;5;5;1;4;4;1
3;2;3;175;41;216;128.385915492958;1;90;176
4;2;4;0;1;1;1;5;5;1
5;1;5;1;0;1;33.5;6;6;2
6;1;1;45;49;94;111.452991452991;6;28;46
7;1;2;0;5;5;1;6;6;1
8;2;3;28;62;90;92.75;6;77;29
9;1;1;237;53;290;84.8745421245421;6;47;238
10;1;2;1;2;3;11.5;6;6;2
11;2;2;0;3;3;1;6;6;1
12;1;3;141;33;174;40.5674044265594;6;43;142
13;2;2;0;3;3;1;6;6;1
14;1;1;0;3;3;1;6;6;1
15;2;4;0;4;4;1;2;2;1
16;1;1;0;1;1;1;6;6;1
17;1;2;0;2;2;1;6;6;1
18;1;6;0;2;2;1;6;6;1
19;1;6;105;27;132;36.0111111111111;6;37;106
20;2;2;2;6;8;54.1666666666667;6;7;3
21;1;2;0;2;2;1;7;7;1
22;1;1;0;3;3;1;6;6;1
23;1;3;0;2;2;1;6;6;1
24;1;3;0;1;1;1;7;7;1
25;2;4;1;2;3;14.5;7;7;2
26;1;6;15;18;33;86.8703703703704;6;41;16
27;2;4;48;40;88;330.565693430657;6;85;49
28;1;3;0;1;1;1;7;7;1
29;1;3;18;13;31;164.142857142857;7;42;19
30;2;1;13;15;28;111.432432432432;7;35;14
31;1;1;0;1;1;1;7;7;1
32;1;3;182;137;319;61.7445414847162;6;59;183
33;2;1;0;3;3;1;7;7;1
34;1;3;37;40;77;182.689655172414;6;24;38
35;2;2;0;2;2;1;7;7;1
36;2;4;86;16;102;126.585820895522;6;24;87
37;1;4;0;1;1;1;7;7;1
38;1;5;37;6;43;32.5479876160991;6;19;38
39;2;2;0;7;7;1;8;8;1
40;2;1;0;2;2;1;8;8;1
41;1;1;178;55;233;60.7099644128114;6;28;179
42;1;4;160;120;280;91.507204610951;8;46;161
43;2;2;1;3;4;12.5;8;8;2
44;2;4;67;25;92;128.39880952381;6;39;68
45;1;4;0;1;1;1;8;8;1
46;1;3;1;4;5;18.5;8;8;2
47;1;3;5;5;10;52.875;8;24;6
48;1;2;35;48;83;106.880434782609;7;37;36
49;2;3;0;1;1;1;8;8;1
50;1;1;34;45;79;101.027397260274;8;41;35
51;1;6;43;33;76;45.259842519685;8;19;44
52;2;2;31;46;77;64.4576271186441;8;47;32
53;1;1;66;10;76;62.1754385964912;8;44;67
54;1;1;2;3;5;226.333333333333;8;21;3
55;1;4;0;2;2;1;8;8;1
56;2;4;12;14;26;50.5333333333333;8;10;13
57;1;5;6;4;10;167.176470588235;8;23;7
58;2;2;4;28;32;36.4;8;13;5
59;2;1;0;18;18;1;8;8;1
60;1;1;15;20;35;78.6904761904762;6;40;16
61;2;4;7;22;29;159.555555555556;8;27;8
62;1;1;41;36;77;42.247191011236;8;20;42
63;2;4;67;71;138;88.0363636363636;6;39;68
64;2;4;0;5;5;1;8;8;1
65;2;4;0;5;5;1;8;8;1
66;1;3;1;4;5;79.5;8;8;2
67;1;3;146;62;208;43.1694444444444;8;54;147
68;1;4;31;32;63;82.9084507042254;7;28;32
69;2;4;39;14;53;25.3728813559322;8;22;40
70;2;4;14;10;24;108.37037037037;8;37;15
71;1;6;2;1;3;2.5;8;8;3
72;2;2;59;75;134;156.439130434783;7;35;60
73;1;4;28;31;59;172.690721649485;8;28;29
74;1;1;43;42;85;113.359550561798;8;23;44
75;1;4;5;11;16;89.4545454545455;6;18;6
76;2;5;2;5;7;71.75;8;18;3
77;1;4;0;1;1;1;8;8;1
78;2;4;1;8;9;15;8;8;2
79;1;2;11;9;20;45;8;13;12
80;1;2;10;14;24;49.1875;8;38;11
81;2;3;3;12;15;440.833333333333;8;43;4
82;2;5;0;3;3;1;7;7;1
83;1;4;12;2;14;324.8125;8;25;13
84;1;4;15;15;30;47.7777777777778;8;60;16
85;1;1;10;21;31;66.0588235294118;8;50;11
86;2;3;1;10;11;36;6;6;2
87;1;3;11;8;19;60.9375;8;34;12
88;1;3;12;33;45;166.162162162162;7;16;13
89;1;4;0;2;2;1;9;9;1
90;1;3;17;27;44;61.9642857142857;9;42;18
91;1;3;4;1;5;71.8571428571429;9;9;5
92;1;3;0;3;3;1;7;7;1
93;1;6;5;5;10;100;8;173;6
94;2;5;5;5;10;57.3333333333333;9;26;6
95;1;1;80;52;132;280.253623188406;6;107;81
96;2;1;15;8;23;61.9705882352941;9;11;16
97;2;2;39;72;111;62.8253012048193;9;26;40
98;1;1;2;9;11;43;9;9;3
99;1;3;9;14;23;78.3333333333333;9;21;10
100;1;4;1;3;4;20.5;9;9;2
101;2;4;23;43;66;110.385714285714;9;31;24
102;1;1;11;21;32;60.5555555555556;9;31;12
103;1;2;233;106;339;60.8716216216216;8;33;234
104;1;1;5;5;10;62.75;8;27;6
105;1;2;219;90;309;140.406113537118;9;50;220
106;1;5;1;2;3;23;8;8;2
107;1;2;0;1;1;1;9;9;1
108;2;3;0;3;3;1;9;9;1
109;2;4;7;24;31;328;9;30;8
110;1;4;1;2;3;50.5;7;7;2
111;2;4;1;2;3;66;7;7;2
112;1;4;0;4;4;1;6;6;1
113;1;1;0;1;1;1;9;9;1
114;2;3;9;6;15;550.213114754098;8;34;10
115;2;6;0;4;4;1;9;9;1
116;1;4;0;2;2;1;8;8;1
117;1;1;0;2;2;1;9;9;1
118;2;3;17;10;27;55.8484848484849;8;37;18
119;1;1;8;11;19;88;9;19;9
120;2;3;5;12;17;32;7;14;6
121;1;4;6;9;15;81.75;9;27;7
122;1;3;0;5;5;1;9;9;1
123;2;5;0;5;5;1;9;9;1
124;1;3;30;36;66;93.1012658227848;9;43;31
125;1;1;3;4;7;150.333333333333;9;45;4
126;2;1;0;4;4;1;9;9;1
127;1;4;18;20;38;113.222222222222;8;90;19
128;2;5;71;66;137;96.2097378277154;9;44;72
129;1;3;1;4;5;2.5;6;6;2
130;2;2;0;1;1;1;9;9;1
131;1;2;30;21;51;87.6511627906977;9;32;31
132;2;2;19;29;48;113.764705882353;7;50;20
133;1;5;2;2;4;41.2;9;9;3
134;2;2;2;6;8;80;9;16;3
135;2;5;8;20;28;53.7857142857143;9;56;9
136;1;1;0;3;3;1;9;9;1
137;1;3;1;2;3;14.6666666666667;7;7;2
138;1;4;0;2;2;1;7;7;1
139;2;5;0;1;1;1;9;9;1
140;2;4;14;14;28;152.647058823529;9;20;15
141;1;4;0;5;5;1;3;3;1
142;1;3;26;29;55;168.076923076923;6;40;27
143;2;3;31;15;46;64.4583333333333;9;43;32
144;2;3;75;63;138;210.790476190476;6;37;76
145;2;1;23;8;31;65.5245901639344;9;38;24
146;1;6;9;4;13;103.869565217391;9;43;10
147;1;1;4;7;11;57.6666666666667;10;21;5
148;2;2;0;3;3;1;7;7;1
149;2;2;3;17;20;105.375;7;34;4
150;1;2;0;1;1;1;10;10;1
151;2;2;8;8;16;31.6;9;28;9
152;2;2;8;13;21;105.305084745763;9;38;9
153;1;4;0;1;1;1;10;10;1
154;2;4;6;19;25;22.375;9;23;7
155;1;4;13;20;33;211.08;7;41;14
156;1;2;0;2;2;1;8;8;1
157;2;3;0;6;6;1;10;10;1
158;2;2;0;4;4;1;9;9;1
159;1;2;0;1;1;1;10;10;1
160;1;1;10;6;16;85.7647058823529;10;77;11
161;1;1;12;11;23;90.8875;10;34;13
162;1;4;5;7;12;245.166666666667;7;29;6
163;1;2;14;13;27;94.9130434782609;9;48;15
164;1;2;5;7;12;11;10;11;6
165;2;2;0;3;3;1;10;10;1
166;2;4;1;7;8;13.5;10;10;2
167;2;3;3;6;9;152.6;10;82;4
168;2;2;4;12;16;38.5714285714286;9;19;5
169;2;3;0;1;1;1;10;10;1
170;1;3;0;1;1;1;10;10;1
171;1;3;1;1;2;5.5;8;8;2
172;1;4;27;26;53;129.604651162791;8;46;28
173;2;2;8;14;22;91.0909090909091;6;32;9
174;1;5;9;14;23;118.318181818182;8;44;10
175;2;2;13;40;53;417.987654320988;10;43;14
176;1;4;115;45;160;60.6542553191489;10;29;116
177;2;2;5;14;19;208.714285714286;11;22;6
178;1;5;0;1;1;1;7;7;1
179;1;3;0;2;2;1;10;10;1
180;2;2;7;9;16;147.25;11;133;8
181;1;2;22;19;41;150.407407407407;11;28;23
182;1;2;0;3;3;1;8;8;1
183;2;2;13;10;23;32.3333333333333;7;25;14
184;1;3;7;17;24;62.4666666666667;11;23;8
185;1;3;6;12;18;39.7142857142857;11;11;7
186;1;2;1;3;4;6.5;11;11;2
187;1;1;3;1;4;58.625;10;191;4
188;2;3;0;4;4;1;11;11;1
189;1;6;36;10;46;210.664335664336;9;36;37
190;2;4;2;8;10;53.3333333333333;11;11;3
191;1;2;35;45;80;132.52427184466;11;35;36
192;2;1;0;4;4;1;11;11;1
193;1;4;55;39;94;201.592039800995;9;59;56
194;2;3;139;97;236;96.0933333333333;11;32;140
195;1;3;0;3;3;1;9;9;1
196;1;3;0;1;1;1;11;11;1
197;1;3;0;1;1;1;11;11;1
198;1;6;7;8;15;223.5;11;57;8
199;1;3;59;43;102;170.834710743802;11;41;60
200;1;4;0;1;1;1;11;11;1
201;1;4;8;10;18;46.5;11;33;9
202;1;5;0;3;3;1;11;11;1
203;1;5;3;5;8;117.8;11;27;4
204;2;3;78;25;103;86.3762376237624;10;36;79
205;1;4;1;1;2;180.5;10;10;2
206;1;3;1;1;2;5.5;8;8;2
207;2;3;0;1;1;1;9;9;1
208;1;4;0;1;1;1;10;10;1
209;1;1;23;28;51;79.9722222222222;11;37;24
210;1;6;0;2;2;1;9;9;1
211;1;6;28;20;48;95.0967741935484;7;35;29
212;2;1;73;63;136;119.872204472843;10;28;74
213;1;6;0;1;1;1;10;10;1
214;1;6;38;21;59;72.1234567901235;11;33;39
215;2;6;3;8;11;32.6666666666667;11;11;4
216;1;1;0;3;3;1;11;11;1
217;1;2;0;1;1;1;11;11;1
218;1;2;0;1;1;1;11;11;1
219;2;2;7;6;13;105;7;51;8
220;2;2;41;27;68;116.345323741007;8;36;42
221;1;4;12;23;35;122.809523809524;11;50;13
222;1;3;1;7;8;53.3333333333333;11;11;2
223;1;4;0;4;4;1;11;11;1
224;1;4;23;30;53;275.934426229508;6;54;24
225;1;5;4;2;6;93.3333333333333;9;41;5
226;1;1;1;4;5;45.5;11;11;2
227;1;4;3;1;4;144.75;11;12;4
228;1;4;23;24;47;348.090909090909;11;32;24
229;1;5;1;0;1;17;7;7;2
230;1;2;0;1;1;1;9;9;1
231;1;2;0;1;1;1;11;11;1
232;1;3;1;2;3;247;7;7;2
233;2;3;20;28;48;187.517647058824;10;88;21
234;1;4;31;25;56;259.225352112676;10;60;32
235;2;1;3;2;5;27.1666666666667;11;14;4
236;1;1;14;29;43;103.166666666667;11;18;15
237;1;4;4;4;8;34.2;9;14;5
238;1;4;0;3;3;1;7;7;1
239;2;1;7;9;16;26.3157894736842;12;26;8
240;1;4;0;1;1;1;6;6;1
241;1;1;2;6;8;80.1666666666667;11;17;3
242;1;2;29;38;67;81.5555555555556;10;36;30
243;1;4;1;4;5;60.5;12;12;2
244;2;3;6;7;13;321.964285714286;11;24;7
245;2;2;20;16;36;53.3428571428571;12;41;21
246;1;6;0;1;1;1;12;12;1
247;1;3;1;2;3;4;12;12;2
248;1;3;5;9;14;26.875;12;15;6
249;1;3;168;97;265;77.4797570850202;12;79;169
250;1;1;53;42;95;68.2357723577236;6;34;54
251;2;4;0;4;4;1;12;12;1
252;1;1;40;46;86;41.078125;12;34;41
253;1;5;0;1;1;1;12;12;1
254;1;1;57;66;123;69.8457943925234;12;42;58
255;1;6;1;1;2;2.5;7;7;2
256;2;1;5;21;26;77.875;12;22;6
257;1;2;20;13;33;166;12;44;21
258;1;5;1;1;2;399.666666666667;12;12;2
259;1;2;12;8;20;157.333333333333;12;21;13
260;2;2;33;48;81;161.631578947368;12;28;34
261;1;2;4;3;7;208.458333333333;10;42;5
262;2;3;0;2;2;1;12;12;1
263;1;1;51;55;106;113.564935064935;10;23;52
264;1;4;1;1;2;15;12;12;2
265;2;6;0;9;9;1;12;12;1
266;1;1;68;11;79;39.0128205128205;10;21;69
267;2;1;3;5;8;19.6;12;12;4
268;1;1;1;0;1;22.5;12;12;2
269;1;4;3;6;9;61;12;36;4
270;2;1;0;5;5;1;12;12;1
271;1;3;8;11;19;123.222222222222;9;48;9
272;1;1;21;20;41;68.5294117647059;12;37;22
273;1;1;3;5;8;56.5;13;17;4
274;1;5;17;12;29;41.4705882352941;12;21;18
275;2;2;1;1;2;10;6;6;2
276;1;5;12;10;22;144.380952380952;10;48;13
277;2;2;85;61;146;106.326666666667;13;34;86
278;1;3;9;21;30;95.6153846153846;10;41;10
279;1;3;0;2;2;1;12;12;1
280;1;3;1;3;4;25;12;12;2
281;1;2;31;40;71;207.478873239437;12;56;32
282;1;3;18;18;36;568.981481481482;12;51;19
283;1;3;31;32;63;107.641025641026;13;39;32
284;2;2;0;5;5;1;13;13;1
285;1;1;9;17;26;59.9333333333333;9;42;10
286;2;4;12;8;20;182.714285714286;8;21;13
287;1;1;0;1;1;1;13;13;1
288;2;2;15;26;41;116.184210526316;13;36;16
289;1;2;40;40;80;69.3305785123967;10;20;41
290;1;3;4;4;8;52.8;13;36;5
291;1;1;7;11;18;21.9090909090909;13;28;8
292;1;4;0;2;2;1;13;13;1
293;1;4;0;3;3;1;12;12;1
294;2;4;15;14;29;64.325;8;27;16
295;1;3;1;4;5;16.5;13;13;2
296;1;3;29;35;64;115.152777777778;13;35;30
297;2;2;69;69;138;70.9723926380368;12;36;70
298;1;3;14;18;32;92.8196721311475;13;53;15
299;1;1;11;31;42;104.090909090909;13;23;12
300;1;2;7;10;17;60.8888888888889;13;21;8
301;1;3;1;1;2;27;9;9;2
302;2;3;40;47;87;184.25;7;37;41
303;1;3;19;19;38;87.7818181818182;13;51;20
304;2;3;1;4;5;140.5;13;13;2
305;1;1;4;6;10;126.857142857143;13;20;5
306;2;1;41;47;88;74.8472222222222;13;42;42
307;2;1;16;10;26;97.328125;13;29;17
308;1;1;84;81;165;75.5824742268041;13;34;85
309;1;1;36;41;77;69.4705882352941;13;41;37
310;1;1;3;1;4;198.666666666667;13;15;4
311;2;1;12;30;42;79.8888888888889;13;28;13
312;1;3;9;13;22;180.211538461538;11;83;10
313;2;1;10;14;24;199.175;13;24;11
314;2;1;24;25;49;151.970149253731;13;34;25
315;2;1;6;18;24;110.416666666667;13;45;7
316;2;2;18;32;50;151.008403361345;13;23;19
317;1;1;51;45;96;58.427027027027;13;44;52
318;2;1;17;23;40;55.6363636363636;13;50;18
319;2;2;14;18;32;108.7;13;52;15
320;1;3;0;1;1;1;9;9;1
321;1;2;105;31;136;38.7010676156584;13;20;106
322;1;3;6;11;17;260.818181818182;14;45;7
323;2;1;96;57;153;68.8114511352419;13;37;97
324;2;1;5;9;14;55.1666666666667;14;14;6
325;1;2;76;77;153;91.8779342723005;13;31;77
326;1;1;5;7;12;42.75;7;47;6
327;1;4;15;8;23;38.9444444444444;7;33;16
328;1;3;2;5;7;23;9;14;3
329;1;6;8;10;18;64.8947368421053;14;48;9
330;1;3;0;1;1;1;13;13;1
331;2;5;0;2;2;1;14;14;1
332;1;1;12;17;29;40.8979591836735;13;29;13
333;1;1;7;12;19;79.9375;13;40;8
334;1;3;20;10;30;62.8863636363636;8;41;21
335;2;2;18;10;28;131.734939759036;14;16;19
336;1;4;6;4;10;81.5;14;19;7
337;1;2;39;41;80;105.467391304348;14;44;40
338;1;1;15;13;28;120.714285714286;14;33;16
339;1;3;28;24;52;229.219512195122;13;37;29
340;1;3;2;6;8;49.5;14;15;3
341;1;1;32;40;72;99.3636363636364;13;44;33
342;1;3;61;33;94;135.953051643192;9;44;62
343;2;2;15;33;48;196.55;14;23;16
344;2;5;8;8;16;183.428571428571;10;17;9
345;2;1;13;7;20;76.08;14;26;14
346;1;2;29;37;66;107.3125;14;48;30
347;1;1;1;3;4;1.5;14;14;2
348;2;1;1;3;4;5.5;14;14;2
349;1;1;10;23;33;68.0625;12;21;11
350;1;1;29;13;42;70.1263157894737;14;36;30
351;1;4;5;5;10;128.875;14;21;6
352;1;1;8;21;29;57.9230769230769;14;43;9
353;2;2;28;38;66;185.507462686567;14;43;29
354;2;1;2;4;6;147.6;9;42;3
355;2;4;7;16;23;310.1;14;21;8
356;1;3;14;16;30;127.782608695652;14;43;15
357;1;4;135;40;175;30.5608108108108;14;50;136
358;1;2;15;24;39;79.5483870967742;14;45;16
359;1;2;3;8;11;77.2666666666667;14;17;4
360;2;2;0;3;3;1;14;14;1
361;1;1;21;12;33;196.777777777778;14;61;22
362;1;1;4;7;11;15.2;14;47;5
363;1;1;6;3;9;105.714285714286;12;19;7
364;2;1;9;12;21;243.571428571429;14;23;10
365;2;1;9;27;36;44;14;19;10
366;2;1;5;6;11;76.8;14;47;6
367;1;2;17;18;35;83.1518987341772;6;44;18
368;1;1;37;51;88;111.885416666667;15;20;38
369;1;2;0;1;1;1;15;15;1
370;1;1;6;7;13;65.4285714285714;14;37;7
371;2;2;11;27;38;130.866666666667;15;23;12
372;1;2;121;115;236;72.5884773662551;14;41;122
373;1;1;5;12;17;56.8421052631579;14;29;6
374;1;3;1;6;7;4;15;15;2
375;2;3;15;26;41;76.1785714285714;15;40;16
376;2;2;14;21;35;37.7083333333333;15;23;15
377;2;1;42;11;53;95.6117647058824;14;36;43
378;2;1;21;29;50;62.1544715447154;15;35;22
379;2;1;14;20;34;100.225806451613;15;28;15
380;2;1;0;3;3;1;15;15;1
381;2;2;0;2;2;1;15;15;1
382;2;1;0;3;3;1;14;14;1
383;1;3;0;2;2;1;15;15;1
384;1;1;2;2;4;25.6666666666667;15;15;3
385;1;4;5;5;10;99.625;8;22;6
386;2;1;9;22;31;91.05;15;20;10
387;1;1;3;4;7;93.7142857142857;15;23;4
388;1;1;24;30;54;85.7878787878788;6;28;25
389;2;1;58;58;116;94.0913705583756;15;41;59
390;2;5;1;2;3;18;15;15;2
391;2;1;18;26;44;54.4285714285714;14;29;19
392;2;1;30;32;62;151.594059405941;15;40;31
393;2;2;33;51;84;84.6194690265487;15;57;34
394;2;1;27;33;60;189.611111111111;13;43;28
395;1;3;4;3;7;191.25;9;16;5
396;2;1;19;37;56;91.4516129032258;15;22;20
397;1;6;0;1;1;1;15;15;1
398;1;2;68;41;109;78.8469387755102;13;44;69
399;1;3;12;6;18;68.5;9;15;13
400;1;3;217;92;309;127.031531531532;15;25;218
401;1;1;4;6;10;87.4444444444444;14;22;5
402;2;1;14;23;37;94.5862068965517;15;34;15
403;1;3;5;5;10;300.333333333333;6;28;6
404;1;1;5;9;14;187.454545454545;15;21;6
405;2;1;13;23;36;63.7837837837838;15;33;14
406;1;3;0;2;2;1;6;6;1
407;2;1;9;13;22;38.85;15;28;10
408;2;2;8;14;22;92.3636363636364;15;37;9
409;2;4;24;14;38;39.0212765957447;15;22;25
410;2;2;1;5;6;58.5;15;15;2
411;2;2;0;3;3;1;15;15;1
412;1;4;0;1;1;1;15;15;1
413;1;1;8;16;24;166;15;21;9
414;1;4;3;2;5;54.5;15;20;4
415;1;3;28;26;54;103;7;61;29
416;1;1;1;4;5;276.5;16;16;2
417;1;2;0;2;2;1;16;16;1
418;1;4;13;12;25;61.75;12;29;14
419;2;4;0;9;9;1;16;16;1
420;2;3;0;4;4;1;16;16;1
421;1;1;6;5;11;34.7777777777778;15;49;7
422;1;1;31;24;55;70.1375;10;32;32
423;1;3;30;8;38;45.58;15;55;31
424;1;1;8;4;12;90.8;16;16;9
425;1;1;10;9;19;37.4285714285714;15;38;11
426;1;3;1;1;2;15;13;13;2
427;1;3;2;2;4;42.6666666666667;15;20;3
428;1;4;1;3;4;192;16;16;2
429;2;2;26;33;59;125.59756097561;16;87;27
430;1;3;23;12;35;21.8484848484848;16;82;24
431;1;2;75;35;110;117.460154241645;6;109;76
432;1;2;3;5;8;56.6;16;17;4
433;1;1;1;2;3;73;16;16;2
434;2;1;1;2;3;20;16;16;2
435;2;1;2;1;3;18.6666666666667;15;16;3
436;2;2;0;3;3;1;14;14;1
437;2;2;7;48;55;158.677419354839;16;30;8
438;1;4;5;15;20;52.9;16;56;6
439;2;1;20;23;43;94.3529411764706;14;31;21
440;1;3;15;20;35;70.7096774193548;16;36;16
441;2;4;2;5;7;33.8;16;16;3
442;1;5;10;8;18;103.923076923077;16;48;11
443;2;2;9;8;17;52.5;16;82;10
444;2;1;0;1;1;1;16;16;1
445;2;3;4;13;17;41.4545454545455;16;27;5
446;2;4;0;2;2;1;16;16;1
447;2;2;32;18;50;107.676923076923;16;53;33
448;1;1;40;27;67;87.8421052631579;15;27;41
449;2;2;11;22;33;98.0625;16;34;12
450;1;3;0;3;3;1;16;16;1
451;2;2;2;7;9;4.5;12;16;3
452;2;1;0;8;8;1;16;16;1
453;1;3;3;4;7;90.4;16;17;4
454;2;4;43;55;98;71.2675438596491;15;40;44
455;1;4;0;1;1;1;16;16;1
456;1;5;36;43;79;219.911392405063;16;78;37
457;2;1;1;3;4;27;14;14;2
458;1;3;0;1;1;1;16;16;1
459;2;1;0;2;2;1;16;16;1
460;2;2;14;39;53;137.477272727273;16;30;15
461;1;1;1;2;3;9;16;16;2
462;1;4;24;21;45;137.166666666667;16;33;25
463;2;1;26;36;62;76.2771084337349;16;35;27
464;2;1;0;7;7;1;16;16;1
465;1;2;6;8;14;226.533333333333;16;36;7
466;2;1;3;10;13;34.6666666666667;16;17;4
467;1;3;1;2;3;100;16;16;2
468;1;1;16;22;38;85.5333333333333;16;43;17
469;1;4;13;9;22;136.128205128205;16;154;14
470;1;4;6;6;12;281.764705882353;13;41;7
471;1;1;0;4;4;1;16;16;1
472;1;5;1;8;9;26.5;16;16;2
473;2;2;7;9;16;52.7857142857143;6;37;8
474;2;2;55;39;94;195.307692307692;16;59;56
475;2;1;55;80;135;79.7472527472527;16;40;56
476;2;3;0;4;4;1;17;17;1
477;1;6;5;8;13;77.95;16;35;6
478;1;3;0;2;2;1;16;16;1
479;1;1;38;44;82;76.59375;17;37;39
480;1;1;1;10;11;5.5;16;16;2
481;1;1;38;44;82;64.1702127659574;17;29;39
482;1;3;53;52;105;130.875968992248;16;45;54
483;2;1;30;18;48;237.590062111801;16;43;31
484;2;2;6;4;10;107.733333333333;9;25;7
485;2;1;2;1;3;121.333333333333;17;17;3
486;1;4;0;1;1;1;17;17;1
487;1;2;8;10;18;97.2222222222222;6;36;9
488;1;3;4;7;11;70.2;16;31;5
489;2;2;1;4;5;45.6666666666667;17;17;2
490;1;1;0;2;2;1;17;17;1
491;1;3;0;1;1;1;16;16;1
492;1;3;24;15;39;61.5689655172414;8;161;25
493;1;1;3;2;5;16.5;13;17;4
494;1;4;14;9;23;61.7777777777778;14;112;15
495;2;1;56;62;118;181.162878787879;15;44;57
496;1;6;10;9;19;77.9523809523809;17;21;11
497;1;1;8;8;16;33.6153846153846;7;44;9
498;1;2;43;45;88;159.783783783784;17;37;44
499;2;2;0;2;2;1;17;17;1
500;2;3;0;3;3;1;17;17;1
501;2;1;6;7;13;74.4857142857143;17;28;7
502;2;1;35;61;96;75.8627450980392;17;46;36
503;2;2;23;15;38;163.978494623656;17;43;24
504;2;1;17;21;38;344.848484848485;17;44;18
505;1;5;0;3;3;1;16;16;1
506;1;5;0;1;1;1;17;17;1
507;1;2;5;5;10;226.315789473684;16;44;6
508;1;2;2;4;6;109.5;17;17;3
509;1;2;50;41;91;54.5145631067961;16;47;51
510;1;1;0;1;1;1;17;17;1
511;1;2;3;8;11;35.5;17;36;4
512;2;5;0;4;4;1;17;17;1
513;2;1;38;55;93;75.6352941176471;17;28;39
514;1;1;33;37;70;87.9848484848485;6;24;34
515;1;3;1;8;9;4.5;17;17;2
516;1;5;9;10;19;75.6666666666667;17;59;10
517;2;1;19;14;33;111;16;30;20
518;1;3;14;13;27;150.833333333333;9;84;15
519;2;3;0;4;4;1;17;17;1
520;1;2;16;11;27;94.9166666666667;17;48;17
521;1;2;1;2;3;3.5;16;16;2
522;1;3;3;3;6;217.75;7;21;4
523;2;6;88;49;137;403.380952380952;17;137;89
524;1;3;0;1;1;1;10;10;1
525;1;3;25;25;50;67.6687898089172;17;77;26
526;1;4;1;2;3;35.6666666666667;17;17;2
527;2;1;12;30;42;79.0526315789474;17;29;13
528;2;4;0;7;7;1;17;17;1
529;2;2;0;3;3;1;17;17;1
530;2;3;0;2;2;1;17;17;1
531;1;4;0;1;1;1;17;17;1
532;1;1;11;13;24;125.227272727273;17;34;12
533;1;5;0;1;1;1;17;17;1
534;2;2;2;8;10;140.571428571429;17;21;3
535;1;1;3;3;6;41.6666666666667;16;25;4
536;2;2;42;50;92;85.2037037037037;18;46;43
537;1;1;14;12;26;74.0476190476191;17;80;15
538;2;2;20;34;54;76.3225806451613;18;50;21
539;1;2;21;6;27;41.4285714285714;18;33;22
540;1;1;26;32;58;71.1967213114754;18;35;27
541;2;1;1;4;5;44;17;17;2
542;1;2;50;56;106;103.648760330579;18;33;51
543;2;3;8;11;19;321.222222222222;18;31;9
544;2;2;12;24;36;78.9666666666667;17;56;13
545;1;1;12;17;29;22.2857142857143;18;34;13
546;1;2;42;23;65;96.9896907216495;17;42;43
547;1;4;29;27;56;89.1958762886598;10;50;30
548;1;2;6;12;18;40.9;18;41;7
549;1;3;14;21;35;138.066666666667;18;34;15
550;1;3;0;2;2;1;18;18;1
551;2;1;25;4;29;159.125;16;24;26
552;1;1;9;4;13;117;9;33;10
553;2;1;3;6;9;159.2;18;18;4
554;1;1;2;5;7;16.6666666666667;18;18;3
555;1;1;58;20;78;71.4695652173913;13;35;59
556;2;4;0;4;4;1;18;18;1
557;1;3;32;28;60;233.939393939394;18;77;33
558;1;4;0;1;1;1;16;16;1
559;1;2;1;4;5;68;18;18;2
560;1;2;20;23;43;53.6;16;41;21
561;2;2;31;32;63;454.286290322581;18;75;32
562;1;1;6;6;12;24;18;23;7
563;1;1;5;5;10;71;18;25;6
564;2;5;0;4;4;1;19;19;1
565;1;4;0;1;1;1;17;17;1
566;2;1;0;9;9;1;19;19;1
567;1;3;22;21;43;91.9512195121951;18;28;23
568;1;1;2;3;5;32.3333333333333;17;19;3
569;2;3;29;26;55;111.189873417722;19;43;30
570;2;1;2;11;13;26;18;36;3
571;1;1;5;8;13;42.4705882352941;19;20;6
572;2;3;0;3;3;1;16;16;1
573;1;5;17;20;37;91.3720930232558;18;42;18
574;2;3;5;4;9;105.083333333333;18;20;6
575;1;1;2;8;10;13.3333333333333;18;19;3
576;2;1;22;23;45;97.7088607594937;19;42;23
577;1;3;1;4;5;24;17;17;2
578;2;1;3;4;7;34.5;19;45;4
579;2;3;0;3;3;1;15;15;1
580;1;1;1;3;4;25.5;19;19;2
581;1;4;5;2;7;43.9333333333333;9;24;6
582;1;5;16;11;27;78.1666666666667;12;79;17
583;2;1;21;26;47;107.734693877551;19;24;22
584;2;4;0;2;2;1;19;19;1
585;1;1;4;5;9;147.222222222222;18;40;5
586;1;1;64;40;104;86.5810055865922;19;30;65
587;2;1;2;8;10;52.3333333333333;19;20;3
588;2;1;14;20;34;34.2142857142857;19;28;15
589;2;1;3;6;9;25.75;16;23;4
590;1;1;34;41;75;41.6268656716418;17;33;35
591;1;4;2;4;6;22.75;19;19;3
592;2;1;17;22;39;127.59375;19;43;18
593;2;3;7;14;21;157;19;28;8
594;1;1;19;15;34;112.230769230769;19;41;20
595;2;2;21;29;50;119.245901639344;19;33;22
596;2;2;31;37;68;215.767441860465;20;37;32
597;1;4;2;8;10;57.3333333333333;20;22;3
598;2;2;77;115;192;69.9468085106383;20;43;78
599;2;2;19;13;32;66.8428571428571;18;26;20
600;2;3;20;4;24;98.0277777777778;19;38;21
601;2;3;6;12;18;41.5454545454545;20;27;7
602;1;2;3;5;8;28.5;20;21;4
603;1;3;13;15;28;63.9512195121951;20;23;14
604;1;1;0;1;1;1;19;19;1
605;2;1;68;46;114;72.1484716157205;20;36;69
606;1;3;8;6;14;86.1176470588235;13;47;9
607;2;2;7;30;37;48.2307692307692;20;21;8
608;1;5;1;1;2;13.5;20;20;2
609;1;2;33;34;67;46.1851851851852;20;42;34
610;1;1;3;4;7;53.8;6;28;4
611;1;1;1;3;4;169.4;20;20;2
612;1;4;4;3;7;124.2;16;20;5
613;2;1;0;2;2;1;20;20;1
614;1;3;1;2;3;50;20;20;2
615;1;1;47;47;94;79.1652173913044;17;48;48
616;2;1;13;21;34;38.875;19;23;14
617;2;1;60;51;111;121.617721518987;20;28;61
618;1;3;1;1;2;7;20;20;2
619;1;5;9;4;13;66.25;19;23;10
620;1;4;21;26;47;358.731707317073;19;77;22
621;2;3;32;22;54;118.559633027523;20;44;33
622;1;1;5;3;8;105.571428571429;20;20;6
623;1;1;0;2;2;1;20;20;1
624;1;1;9;5;14;50.5384615384615;9;24;10
625;1;2;8;9;17;79.8478260869565;20;21;9
626;2;1;51;70;121;67.1898734177215;20;37;52
627;2;1;13;17;30;41.3913043478261;20;37;14
628;1;2;0;2;2;1;17;17;1
629;1;4;4;4;8;110.714285714286;20;23;5
630;1;2;0;2;2;1;20;20;1
631;1;2;10;0;10;40.95;20;21;11
632;1;2;9;22;31;92.5789473684211;20;24;10
633;1;2;0;2;2;1;20;20;1
634;1;3;8;3;11;121;6;33;9
635;2;2;9;9;18;72.7619047619048;20;43;10
636;1;1;8;14;22;21.5714285714286;20;21;9
637;1;1;0;4;4;1;20;20;1
638;2;1;137;119;256;34.3165829145729;20;33;138
639;2;1;39;34;73;93.8571428571429;20;44;40
640;1;1;30;31;61;57.6483516483516;20;36;31
641;1;1;2;7;9;48;12;20;3
642;1;2;38;40;78;71.2745098039216;20;41;39
643;1;1;5;6;11;29.8571428571429;20;30;6
644;1;1;65;67;132;92.8345323741007;20;44;66
645;1;3;11;23;34;136.785714285714;20;37;12
646;1;1;17;15;32;62.4918032786885;20;22;18
647;1;1;1;2;3;28;20;20;2
648;1;1;10;0;10;84.3888888888889;20;20;11
649;1;1;9;18;27;33.9545454545455;20;21;10
650;1;1;0;4;4;1;20;20;1
651;1;1;3;8;11;133.333333333333;20;21;4
652;1;6;58;44;102;127.748663101604;19;77;59
653;1;2;0;1;1;1;8;8;1
654;2;1;44;60;104;71.7407407407407;20;37;45
655;1;2;19;1;20;33.3181818181818;20;21;20
656;1;2;0;1;1;1;20;20;1
657;2;2;1;6;7;30.3333333333333;20;20;2
658;1;1;12;21;33;106.461538461538;20;30;13
659;2;1;6;15;21;46.4545454545455;19;24;7
660;2;1;4;4;8;75.75;19;22;5
661;1;2;0;2;2;1;20;20;1
662;1;2;1;3;4;34;20;20;2
663;2;1;0;2;2;1;21;21;1
664;2;3;0;1;1;1;20;20;1
665;1;1;1;1;2;6;20;20;2
666;1;1;5;5;10;93.6666666666667;20;39;6
667;1;4;10;11;21;47.2608695652174;20;35;11
668;1;1;0;1;1;1;20;20;1
669;1;1;1;4;5;22.5;20;20;2
670;1;2;0;1;1;1;20;20;1
671;1;4;0;1;1;1;20;20;1
672;1;3;0;1;1;1;20;20;1
673;2;2;29;33;62;101.22641509434;16;96;30
674;1;6;18;10;28;393.275862068966;20;111;19
675;2;4;1;6;7;184.416666666667;20;20;2
676;2;2;5;10;15;173.142857142857;21;29;6
677;1;4;1;4;5;26.5;21;21;2
678;1;1;11;8;19;65.7619047619048;21;22;12
679;1;2;78;52;130;91.4285714285714;9;35;79
680;2;2;2;3;5;89.3333333333333;21;21;3
681;1;1;41;25;66;71.6648936170213;21;38;42
682;2;4;0;4;4;1;16;16;1
683;1;1;23;24;47;140.763888888889;20;36;24
684;2;3;0;1;1;1;21;21;1
685;1;4;1;1;2;4.5;9;9;2
686;2;3;34;24;58;63.8468468468468;21;30;35
687;1;1;59;55;114;38.8897637795276;21;37;60
688;1;1;4;9;13;81;21;21;5
689;1;3;2;6;8;110.714285714286;21;23;3
690;1;1;0;1;1;1;16;16;1
691;1;2;0;2;2;1;21;21;1
692;1;4;0;1;1;1;21;21;1
693;2;2;0;1;1;1;21;21;1
694;2;1;0;1;1;1;21;21;1
695;1;1;0;1;1;1;21;21;1
696;1;1;2;1;3;65;14;21;3
697;2;2;62;67;129;74.7116564417178;21;57;63
698;2;3;1;14;15;53;21;21;2
699;2;1;7;12;19;35.5454545454545;21;80;8
700;2;2;14;11;25;121.416666666667;16;40;15
701;2;2;40;41;81;79.7623762376238;18;39;41
702;1;1;0;1;1;1;15;15;1
703;1;1;0;2;2;1;21;21;1
704;1;6;101;56;157;90.1165644171779;21;42;102
705;1;4;8;2;10;88.5625;21;23;9
706;1;1;21;14;35;101.151515151515;21;44;22
707;2;1;0;21;21;1;21;21;1
708;2;3;26;41;67;160.695652173913;21;50;27
709;1;1;3;1;4;37.2;12;41;4
710;2;1;24;27;51;50.8;16;106;25
711;2;2;29;48;77;92.381679389313;21;44;30
712;2;1;24;32;56;140.989898989899;21;27;25
713;2;2;148;95;243;240.015659955257;21;36;149
714;1;2;25;26;51;134.68085106383;17;44;26
715;1;2;2;2;4;38.3333333333333;21;24;3
716;1;2;4;6;10;120.9;7;29;5
717;1;2;0;1;1;1;11;11;1
718;1;2;0;1;1;1;21;21;1
719;1;2;35;48;83;70.8452380952381;21;43;36
720;1;1;3;4;7;69;21;27;4
721;2;1;10;14;24;67.4782608695652;21;24;11
722;1;2;0;1;1;1;21;21;1
723;2;1;2;4;6;96.25;21;22;3
724;1;4;4;10;14;90.6;15;26;5
725;1;3;32;30;62;158.971014492754;21;42;33
726;1;3;8;9;17;79.3333333333333;22;28;9
727;1;1;11;10;21;419.391304347826;22;75;12
728;1;5;14;9;23;71.2708333333333;21;23;15
729;1;2;0;3;3;1;10;10;1
730;1;4;0;1;1;1;11;11;1
731;2;1;4;5;9;64.2857142857143;22;42;5
732;1;2;6;7;13;34;19;37;7
733;1;5;64;24;88;18.4745762711864;21;43;65
734;2;1;9;12;21;111.4375;21;35;10
735;2;1;8;11;19;330.47619047619;22;49;9
736;1;1;1;2;3;89.5;14;14;2
737;1;4;1;3;4;2;22;22;2
738;1;1;8;15;23;111.238095238095;22;40;9
739;1;1;18;15;33;49;22;35;19
740;1;1;5;10;15;29.625;21;38;6
741;1;3;15;15;30;226.589743589744;22;38;16
742;2;1;0;1;1;1;21;21;1
743;2;4;0;4;4;1;22;22;1
744;1;3;0;2;2;1;22;22;1
745;1;1;0;1;1;1;19;19;1
746;2;1;1;2;3;10.5;14;14;2
747;2;4;2;4;6;40;22;22;3
748;1;3;0;3;3;1;22;22;1
749;1;2;17;15;32;221.848484848485;21;44;18
750;1;2;0;1;1;1;21;21;1
751;1;1;2;3;5;118;21;51;3
752;1;2;12;15;27;65.6666666666667;22;42;13
753;2;1;37;49;86;58.0064516129032;22;35;38
754;1;1;12;9;21;54.8947368421053;22;23;13
755;1;2;8;11;19;54.5454545454545;22;35;9
756;1;6;0;1;1;1;21;21;1
757;2;1;3;6;9;33.5714285714286;22;24;4
758;2;1;34;40;74;53.8837209302326;22;36;35
759;2;2;0;1;1;1;22;22;1
760;1;1;9;3;12;52.3888888888889;17;39;10
761;2;5;6;7;13;66.05;22;23;7
762;1;1;20;23;43;54.5833333333333;22;44;21
763;2;2;0;1;1;1;21;21;1
764;2;1;0;2;2;1;14;14;1
765;2;1;28;35;63;100.197530864198;22;25;29
766;2;2;12;17;29;57.5614035087719;21;28;13
767;1;3;4;1;5;38.1666666666667;22;23;5
768;2;3;41;34;75;231.055555555556;22;53;42
769;1;2;0;12;12;1;22;22;1
770;1;6;88;22;110;106.186956521739;8;41;89
771;1;3;12;16;28;144;22;28;13
772;2;2;0;3;3;1;23;23;1
773;2;2;1;15;16;222.5;23;23;2
774;2;2;4;17;21;68.8181818181818;23;23;5
775;1;2;0;3;3;1;20;20;1
776;2;1;5;4;9;150.142857142857;23;24;6
777;1;1;34;25;59;103.285714285714;22;33;35
778;1;2;14;17;31;23.0588235294118;23;45;15
779;1;2;18;18;36;55.125;23;37;19
780;1;1;2;3;5;27.4444444444444;23;23;3
781;1;2;37;27;64;100.051724137931;22;44;38
782;1;2;8;10;18;448.733333333333;23;39;9
783;2;1;41;53;94;62.3928571428571;23;42;42
784;2;1;0;26;26;1;23;23;1
785;1;2;6;7;13;116.076923076923;23;28;7
786;1;1;2;1;3;76.25;23;23;3
787;1;6;9;7;16;78.8947368421053;23;34;10
788;2;2;7;16;23;53.2777777777778;23;50;8
789;1;3;1;1;2;85;23;23;2
790;1;2;3;6;9;110.8;23;24;4
791;1;6;1;1;2;53;23;23;2
792;2;3;28;20;48;132.327102803738;23;44;29
793;1;1;18;11;29;75.8857142857143;23;37;19
794;1;3;14;21;35;139.347826086957;23;44;15
795;1;1;7;18;25;58;23;27;8
796;1;4;1;0;1;4.5;22;22;2
797;1;3;38;20;58;84;6;44;39
798;2;1;2;24;26;29;23;23;3
799;2;3;19;19;38;89.4761904761905;15;67;20
800;1;1;18;12;30;60.4777777777778;21;41;19
801;2;1;11;9;20;125.1875;23;34;12
802;2;1;8;19;27;147;23;39;9
803;1;3;0;1;1;1;23;23;1
804;2;3;0;2;2;1;23;23;1
805;1;1;10;5;15;88.2;7;23;11
806;2;3;1;4;5;12.5;20;20;2
807;1;1;1;1;2;22;23;23;2
808;1;3;2;5;7;122.5;7;24;3
809;2;3;57;26;83;173.64;6;58;58
810;1;3;26;13;39;207.345679012346;23;49;27
811;2;4;2;3;5;30.8;23;23;3
812;1;3;6;8;14;111.882352941176;22;85;7
813;2;1;0;2;2;1;23;23;1
814;1;4;10;16;26;129.020833333333;20;28;11
815;2;1;18;46;64;68.2173913043478;23;36;19
816;2;1;0;8;8;1;23;23;1
817;1;1;18;28;46;114.578947368421;23;37;19
818;2;3;8;9;17;134.0625;8;124;9
819;2;3;5;8;13;36.3;23;25;6
820;1;4;0;1;1;1;23;23;1
821;1;3;7;7;14;215.361111111111;23;44;8
822;2;2;12;12;24;145.58;23;51;13
823;2;2;50;53;103;121.982062780269;23;38;51
824;1;2;8;13;21;56.4444444444444;23;42;9
825;2;2;0;7;7;1;23;23;1
826;2;3;5;1;6;91;23;24;6
827;1;4;1;0;1;36;16;16;2
828;1;1;2;5;7;58.25;23;24;3
829;1;2;1;1;2;3;17;17;2
830;1;1;26;26;52;168.278260869565;24;26;27
831;2;1;25;28;53;69.5072463768116;23;41;26
832;2;3;1;7;8;7;24;24;2
833;1;1;0;2;2;1;23;23;1
834;1;4;36;37;73;66.4322580645161;23;34;37
835;2;3;22;28;50;166.247422680412;24;31;23
836;1;2;2;4;6;51.6666666666667;23;24;3
837;1;1;1;0;1;15;23;23;2
838;1;1;8;9;17;48.8181818181818;24;41;9
839;2;1;0;6;6;1;24;24;1
840;2;1;55;90;145;50.7551020408163;24;36;56
841;2;2;12;16;28;63.2272727272727;24;34;13
842;1;2;1;2;3;974.25;24;24;2
843;2;2;35;31;66;77.3285714285714;24;56;36
844;2;1;0;6;6;1;19;19;1
845;1;2;1;0;1;9;24;24;2
846;1;3;4;4;8;51.625;18;38;5
847;1;3;30;37;67;180.28125;23;127;31
848;2;3;2;6;8;47;24;37;3
849;2;1;0;2;2;1;24;24;1
850;1;1;0;1;1;1;24;24;1
851;1;2;8;6;14;78.8333333333333;24;28;9
852;2;4;18;16;34;101.588235294118;24;48;19
853;2;1;10;11;21;62.3529411764706;21;27;11
854;1;2;0;1;1;1;21;21;1
855;2;1;0;2;2;1;24;24;1
856;1;1;9;8;17;153.4375;22;43;10
857;1;3;2;3;5;22.8;24;25;3
858;2;1;2;2;4;178;24;24;3
859;2;1;35;16;51;81.7972972972973;23;39;36
860;2;1;0;2;2;1;24;24;1
861;1;2;3;5;8;15.2;24;24;4
862;2;4;0;15;15;1;24;24;1
863;2;2;0;4;4;1;24;24;1
864;2;1;8;9;17;58.5294117647059;23;45;9
865;1;4;6;10;16;39.1111111111111;24;34;7
866;2;2;2;4;6;55.8333333333333;20;24;3
867;1;1;1;1;2;3;21;21;2
868;2;4;8;14;22;250.525;24;175;9
869;1;4;2;3;5;40;23;24;3
870;1;3;8;8;16;76.5714285714286;17;43;9
871;1;1;75;17;92;49.23;20;43;76
872;2;1;0;2;2;1;22;22;1
873;1;3;6;4;10;167.846153846154;23;25;7
874;2;1;11;16;27;62.6315789473684;25;41;12
875;1;4;0;2;2;1;17;17;1
876;1;1;4;1;5;47;19;25;5
877;1;3;0;1;1;1;22;22;1
878;1;3;35;23;58;65.6470588235294;25;51;36
879;1;4;0;1;1;1;17;17;1
880;1;1;0;1;1;1;25;25;1
881;1;2;10;14;24;86.9047619047619;10;35;11
882;2;1;8;11;19;51.5;25;25;9
883;1;1;6;6;12;53.5;25;50;7
884;1;4;14;16;30;269.645454545455;25;33;15
885;1;1;2;4;6;35.6666666666667;18;25;3
886;2;5;2;10;12;57.25;25;51;3
887;2;3;0;3;3;1;9;9;1
888;2;2;0;1;1;1;16;16;1
889;1;3;0;1;1;1;24;24;1
890;2;1;0;2;2;1;16;16;1
891;2;1;0;1;1;1;21;21;1
892;2;3;0;1;1;1;21;21;1
893;2;1;8;15;23;112.8;22;47;9
894;2;2;0;1;1;1;19;19;1
895;2;2;0;1;1;1;24;24;1
896;2;5;0;1;1;1;9;9;1
897;2;3;0;1;1;1;22;22;1
898;2;2;2;6;8;32.5;21;36;3
899;2;4;9;13;22;40.1666666666667;9;38;10
900;2;2;0;2;2;1;18;18;1
901;2;4;7;10;17;69.6;25;28;8
902;2;4;0;1;1;1;8;8;1
903;1;2;6;11;17;22.375;24;39;7
904;1;1;0;1;1;1;24;24;1
905;1;2;0;1;1;1;24;24;1
906;1;3;0;1;1;1;24;24;1
907;2;2;0;2;2;1;16;16;1
908;2;1;8;10;18;46.6666666666667;22;42;9
909;2;3;0;2;2;1;7;7;1
910;2;3;0;1;1;1;23;23;1
911;2;2;0;1;1;1;16;16;1
912;1;2;12;12;24;78.1034482758621;25;48;13
913;2;3;23;26;49;72.2816901408451;24;26;24
914;1;1;0;2;2;1;24;24;1
915;1;1;19;16;35;158.847826086957;25;31;20
916;1;1;0;1;1;1;25;25;1
917;2;3;1;2;3;1.5;25;25;2
918;1;3;1;0;1;21.5;21;21;2
919;2;1;26;24;50;58.575;25;50;27
920;2;4;1;2;3;53.3333333333333;25;25;2
921;1;1;2;3;5;35.6666666666667;24;25;3
922;1;4;0;2;2;1;25;25;1
923;1;2;4;6;10;80.6666666666667;15;38;5
924;2;3;7;11;18;95.3684210526316;25;26;8
925;1;5;2;2;4;23;25;25;3
926;2;1;7;10;17;129;25;28;8
927;1;3;1;9;10;103.25;25;25;2
928;2;3;36;38;74;83.5277777777778;25;37;37
929;2;1;0;2;2;1;24;24;1
930;2;3;0;2;2;1;25;25;1
931;2;2;0;3;3;1;25;25;1
932;2;3;2;3;5;132.333333333333;25;42;3
933;1;2;10;11;21;114.58064516129;12;56;11
934;1;2;7;5;12;57.0434782608696;25;32;8
935;1;1;1;1;2;6.5;26;26;2
936;2;4;1;1;2;32;26;26;2
937;1;2;0;1;1;1;26;26;1
938;2;2;19;27;46;34.3260869565217;26;41;20
939;1;1;23;15;38;59;25;34;24
940;1;4;14;13;27;33.8461538461538;26;26;15
941;1;1;2;3;5;79.8;21;26;3
942;1;2;20;12;32;117.553191489362;26;43;21
943;2;1;7;15;22;81.125;26;42;8
944;1;6;13;4;17;88.08;26;37;14
945;1;3;1;1;2;8;16;16;2
946;1;1;0;1;1;1;17;17;1
947;1;1;0;1;1;1;7;7;1
948;2;2;0;1;1;1;26;26;1
949;1;4;15;17;32;221.214285714286;24;33;16
950;1;1;36;37;73;119.900709219858;12;37;37
951;2;1;1;1;2;94.5;26;26;2
952;2;1;8;18;26;158.083333333333;26;43;9
953;1;2;6;5;11;67.2857142857143;19;26;7
954;2;3;5;5;10;59.125;23;34;6
955;1;3;0;2;2;1;17;17;1
956;1;5;1;2;3;19.5;24;24;2
957;2;4;0;4;4;1;26;26;1
958;2;2;4;7;11;327.8;26;26;5
959;1;2;2;4;6;351.125;16;31;3
960;2;3;0;2;2;1;26;26;1
961;1;1;1;2;3;4;26;26;2
962;1;1;3;3;6;46.6;26;28;4
963;1;2;7;12;19;179.071428571429;26;41;8
964;2;1;14;17;31;152.68;26;39;15
965;1;4;2;2;4;26.6;26;26;3
966;1;4;12;16;28;193.97619047619;9;29;13
967;2;5;15;15;30;120.317073170732;26;54;16
968;1;2;1;0;1;52;7;7;2
969;2;2;33;39;72;117.888888888889;27;81;34
970;1;3;11;13;24;68.8529411764706;27;103;12
971;2;2;8;10;18;69.65;27;28;9
972;1;4;1;1;2;2.5;27;27;2
973;2;4;6;6;12;58.2380952380952;27;54;7
974;2;3;3;15;18;54.125;26;27;4
975;2;2;19;27;46;98.1612903225806;26;41;20
976;2;1;0;2;2;1;27;27;1
977;2;1;1;4;5;21.5;27;27;2
978;2;2;7;11;18;96.9;27;28;8
979;2;2;1;2;3;93.3333333333333;27;27;2
980;1;4;12;8;20;81.1538461538462;27;44;13
981;1;1;3;4;7;82.8571428571429;27;27;4
982;1;1;0;1;1;1;26;26;1
983;2;2;9;16;25;78.6470588235294;28;44;10
984;1;1;7;11;18;95.0555555555556;27;55;8
985;1;2;3;4;7;30.625;28;28;4
986;2;2;48;13;61;46.2076923076923;28;41;49
987;2;4;0;8;8;1;23;23;1
988;2;1;5;10;15;54.25;27;28;6
989;1;3;0;2;2;1;28;28;1
990;1;4;12;18;30;109.815789473684;28;33;13
991;1;3;16;15;31;58.5294117647059;28;30;17
992;2;1;9;24;33;75;28;29;10
993;1;2;16;15;31;82.2619047619048;28;44;17
994;1;1;23;22;45;120.875;28;42;24
995;1;2;9;10;19;57.9411764705882;28;37;10
996;1;2;9;6;15;66.3125;28;28;10
997;2;2;8;12;20;146.432432432432;28;39;9
998;1;4;8;8;16;166.357142857143;28;30;9
999;1;2;6;6;12;77.3888888888889;25;30;7
1000;1;1;34;17;51;94.4150943396226;28;29;35
1001;1;4;2;3;5;22;15;28;3
1002;2;3;5;6;11;70.1428571428571;28;34;6
1003;1;1;2;2;4;46.6666666666667;28;29;3
1004;1;5;27;25;52;81.041095890411;28;33;28
1005;1;2;6;10;16;20;28;29;7
1006;1;1;8;16;24;41.4444444444444;28;44;9
1007;1;1;0;1;1;1;28;28;1
1008;1;1;2;2;4;47.6666666666667;28;28;3
1009;1;4;8;5;13;524.666666666667;26;84;9
1010;1;1;1;1;2;145;9;9;2
1011;2;1;0;1;1;1;24;24;1
1012;2;4;0;4;4;1;28;28;1
1013;1;2;18;8;26;150.744680851064;27;88;19
1014;1;3;13;17;30;124.181818181818;27;36;14
1015;2;2;0;9;9;1;28;28;1
1016;2;2;0;2;2;1;24;24;1
1017;1;2;1;2;3;55.5;28;28;2
1018;1;3;32;28;60;112.755102040816;28;44;33
1019;1;4;8;15;23;107.466666666667;29;29;9
1020;1;3;0;2;2;1;19;19;1
1021;2;2;21;36;57;58.4146341463415;28;48;22
1022;1;3;3;3;6;47.75;19;29;4
1023;1;2;11;12;23;85.1538461538462;27;35;12
1024;2;1;0;4;4;1;29;29;1
1025;1;1;2;2;4;25;29;29;3
1026;1;5;21;32;53;73.2592592592593;28;50;22
1027;1;2;0;1;1;1;6;6;1
1028;1;2;2;2;4;16;29;29;3
1029;2;1;15;14;29;52.4074074074074;29;58;16
1030;1;2;1;0;1;31.6666666666667;23;23;2
1031;1;2;10;6;16;57.1304347826087;28;33;11
1032;1;1;8;18;26;58.6527777777778;29;36;9
1033;1;1;42;34;76;108.538461538462;29;42;43
1034;1;2;18;25;43;98.1348314606742;29;35;19
1035;1;2;1;2;3;15;29;29;2
1036;1;2;16;19;35;140.19512195122;29;43;17
1037;1;2;15;9;24;131.708333333333;29;31;16
1038;1;2;13;4;17;66;29;43;14
1039;2;1;14;32;46;137.872340425532;29;42;15
1040;2;1;4;5;9;93.4285714285714;29;29;5
1041;2;3;6;9;15;46.8571428571429;29;35;7
1042;1;2;41;35;76;91.7304964539007;29;54;42
1043;1;1;9;11;20;73.979797979798;9;37;10
1044;1;4;4;5;9;40.2608695652174;29;43;5
1045;1;1;6;6;12;77.6923076923077;29;41;7
1046;2;4;1;3;4;29.3333333333333;29;29;2
1047;1;1;1;4;5;4;29;29;2
1048;1;1;0;1;1;1;19;19;1
1049;1;1;8;14;22;61.1875;28;34;9
1050;2;2;9;21;30;35.1538461538462;30;37;10
1051;1;1;1;10;11;5;8;8;2
1052;1;3;26;17;43;73.6417910447761;30;153;27
1053;2;3;0;7;7;1;29;29;1
1054;1;1;5;6;11;54.75;28;30;6
1055;1;3;0;1;1;1;30;30;1
1056;2;1;11;22;33;93.96875;30;37;12
1057;1;2;0;1;1;1;30;30;1
1058;1;2;2;3;5;60.5;30;30;3
1059;1;2;7;7;14;294.416666666667;30;37;8
1060;2;2;10;15;25;157.36;31;44;11
1061;1;3;1;0;1;111;16;16;2
1062;2;1;11;10;21;44.7857142857143;31;46;12
1063;1;2;1;7;8;11;18;18;2
1064;1;1;6;1;7;31.2;20;187;7
1065;1;1;4;4;8;38;29;41;5
1066;1;2;8;9;17;36.3913043478261;31;36;9
1067;2;1;0;1;1;1;29;29;1
1068;2;3;11;21;32;86.3428571428571;31;34;12
1069;2;1;20;13;33;61.3414634146341;31;34;21
1070;1;3;3;5;8;67.8888888888889;31;35;4
1071;1;6;3;6;9;54.5714285714286;31;34;4
1072;2;2;23;45;68;71.0833333333333;31;44;24
1073;1;1;0;1;1;1;31;31;1
1074;2;4;2;3;5;5.66666666666667;29;77;3
1075;1;4;5;6;11;506;24;52;6
1076;1;4;4;2;6;14.2;29;31;5
1077;1;1;1;3;4;25.5;20;20;2
1078;2;3;2;3;5;41.3333333333333;31;31;3
1079;1;6;13;11;24;113.26582278481;10;181;14
1080;1;5;3;7;10;199.833333333333;23;31;4
1081;1;3;2;3;5;70.3333333333333;31;56;3
1082;1;4;1;1;2;26.6666666666667;29;29;2
1083;1;3;11;12;23;79.4666666666667;31;42;12
1084;1;3;0;1;1;1;14;14;1
1085;1;4;0;1;1;1;9;9;1
1086;1;1;0;1;1;1;20;20;1
1087;1;1;13;0;13;38.96;31;39;14
1088;1;1;0;1;1;1;13;13;1
1089;1;1;6;0;6;127.052631578947;30;42;7
1090;1;3;1;2;3;16.5;30;30;2
1091;2;3;1;6;7;158.5;32;32;2
1092;2;1;0;4;4;1;31;31;1
1093;1;2;11;12;23;46.3;32;37;12
1094;1;3;1;2;3;12.5;6;6;2
1095;1;1;0;1;1;1;32;32;1
1096;2;1;0;1;1;1;19;19;1
1097;2;1;17;20;37;66.325;32;41;18
1098;2;2;0;1;1;1;28;28;1
1099;2;2;1;4;5;9.5;32;32;2
1100;2;1;5;12;17;78.5555555555556;32;34;6
1101;1;2;15;6;21;102.071428571429;32;44;16
1102;2;3;1;4;5;87;32;32;2
1103;1;1;10;32;42;37;32;38;11
1104;1;1;3;6;9;51.8333333333333;33;34;4
1105;1;2;9;10;19;108.325;9;43;10
1106;1;1;0;1;1;1;12;12;1
1107;1;1;3;5;8;14;33;34;4
1108;1;2;0;3;3;1;33;33;1
1109;2;1;0;1;1;1;21;21;1
1110;1;3;10;5;15;243.888888888889;9;42;11
1111;2;2;8;14;22;61.4;33;37;9
1112;2;1;0;1;1;1;31;31;1
1113;1;4;69;29;98;93.5950704225352;33;48;70
1114;1;4;4;3;7;27.1666666666667;31;37;5
1115;1;1;0;1;1;1;28;28;1
1116;1;1;0;2;2;1;33;33;1
1117;2;3;13;22;35;115.428571428571;34;43;14
1118;2;2;36;30;66;74.019801980198;34;62;37
1119;1;3;1;0;1;11.6666666666667;24;24;2
1120;2;1;4;1;5;47.5;33;35;5
1121;2;2;3;5;8;35.7142857142857;34;35;4
1122;1;1;0;4;4;1;34;34;1
1123;1;2;3;5;8;33.8333333333333;34;41;4
1124;1;1;2;5;7;65;34;34;3
1125;2;1;0;2;2;1;32;32;1
1126;2;2;4;4;8;56.4285714285714;34;39;5
1127;1;2;61;42;103;85.9611650485437;34;101;62
1128;1;2;1;1;2;13.75;34;34;2
1129;1;2;1;3;4;43;34;34;2
1130;1;1;8;18;26;54.2352941176471;34;58;9
1131;1;1;4;14;18;96.75;34;34;5
1132;2;2;17;19;36;191.162790697674;34;90;18
1133;1;1;0;1;1;1;34;34;1
1134;1;5;0;1;1;1;34;34;1
1135;1;3;0;1;1;1;34;34;1
1136;2;2;31;23;54;81.2551020408163;34;42;32
1137;2;3;3;7;10;70.2857142857143;34;36;4
1138;1;3;15;18;33;77.8526315789474;34;43;16
1139;1;1;0;7;7;1;34;34;1
1140;1;1;1;0;1;6.5;34;34;2
1141;2;2;0;2;2;1;34;34;1
1142;2;2;24;24;48;145.222222222222;34;48;25
1143;1;1;0;1;1;1;34;34;1
1144;1;1;0;2;2;1;34;34;1
1145;1;2;0;2;2;1;34;34;1
1146;1;2;2;4;6;33;34;37;3
1147;1;1;0;1;1;1;34;34;1
1148;1;3;0;1;1;1;33;33;1
1149;1;4;0;2;2;1;34;34;1
1150;1;5;0;1;1;1;33;33;1
1151;1;1;0;1;1;1;33;33;1
1152;1;2;0;1;1;1;33;33;1
1153;1;1;6;6;12;100.311111111111;22;43;7
1154;1;2;3;4;7;14.1666666666667;9;37;4
1155;2;1;1;0;1;35;33;33;2
1156;1;2;0;2;2;1;35;35;1
1157;1;3;0;3;3;1;20;20;1
1158;1;2;27;24;51;150.253424657534;34;54;28
1159;2;1;1;0;1;42;27;27;2
1160;1;4;0;1;1;1;35;35;1
1161;2;4;2;6;8;28;35;39;3
1162;1;3;3;2;5;8.16666666666667;35;35;4
1163;1;2;2;5;7;38.75;24;35;3
1164;1;2;0;1;1;1;27;27;1
1165;1;3;4;2;6;83.6666666666667;34;36;5
1166;1;2;1;1;2;21;29;29;2
1167;1;2;20;19;39;457.302325581395;34;157;21
1168;1;3;19;21;40;60.4621848739496;35;120;20
1169;2;4;8;9;17;61.1;35;45;9
1170;2;1;0;1;1;1;35;35;1
1171;1;1;2;5;7;19.3333333333333;21;41;3
1172;1;3;1;1;2;5;35;35;2
1173;1;1;10;14;24;197.04347826087;35;45;11
1174;1;5;6;10;16;122.454545454545;35;37;7
1175;1;4;3;4;7;90;35;157;4
1176;1;2;4;5;9;168.619047619048;35;37;5
1177;1;2;1;2;3;145;34;34;2
1178;2;3;17;7;24;130.066666666667;35;42;18
1179;1;5;3;3;6;136;9;49;4
1180;1;4;6;6;12;55.1666666666667;35;36;7
1181;2;3;27;29;56;82.1692307692308;35;77;28
1182;2;4;3;6;9;38.5;35;36;4
1183;2;3;24;27;51;56.2790697674419;35;45;25
1184;2;2;23;22;45;57.9134615384615;36;44;24
1185;1;2;56;38;94;67.1634615384615;36;51;57
1186;1;2;9;10;19;71.5714285714286;35;36;10
1187;1;1;9;14;23;83;36;40;10
1188;2;2;1;5;6;96.5;35;35;2
1189;1;2;89;71;160;89.31875;36;45;90
1190;2;2;33;25;58;193.716666666667;36;51;34
1191;2;1;0;4;4;1;36;36;1
1192;1;4;0;2;2;1;9;9;1
1193;1;6;0;2;2;1;36;36;1
1194;1;3;1;2;3;3;22;22;2
1195;2;2;4;4;8;108.071428571429;36;38;5
1196;2;3;8;8;16;62.4;36;37;9
1197;2;4;0;1;1;1;36;36;1
1198;2;2;5;4;9;62.5;36;37;6
1199;1;1;7;4;11;64;35;36;8
1200;1;1;0;1;1;1;36;36;1
1201;2;1;0;1;1;1;28;28;1
1202;1;2;1;2;3;24.5;36;36;2
1203;1;2;1;1;2;9.5;16;16;2
1204;2;1;0;2;2;1;36;36;1
1205;1;4;1;0;1;12;12;12;2
1206;2;5;1;5;6;6.5;36;36;2
1207;2;5;3;4;7;12.5;36;39;4
1208;2;2;0;10;10;1;36;36;1
1209;2;3;3;4;7;40.875;36;36;4
1210;1;1;0;2;2;1;28;28;1
1211;2;2;8;11;19;36.6111111111111;36;44;9
1212;1;4;0;1;1;1;20;20;1
1213;1;1;14;8;22;30.2068965517241;36;40;15
1214;2;2;12;6;18;106.404761904762;36;37;13
1215;2;2;27;15;42;60.8767123287671;36;44;28
1216;2;5;3;12;15;39.5;36;43;4
1217;2;3;12;26;38;71.0344827586207;36;48;13
1218;2;2;1;2;3;19;37;37;2
1219;1;2;4;4;8;77.4;36;37;5
1220;1;1;1;2;3;129;28;28;2
1221;2;4;0;1;1;1;36;36;1
1222;1;4;0;1;1;1;36;36;1
1223;2;3;2;3;5;57.5;37;37;3
1224;1;1;8;9;17;90.7368421052632;37;39;9
1225;1;1;2;2;4;50.75;37;37;3
1226;1;2;2;3;5;68.75;29;37;3
1227;1;2;13;18;31;64.4545454545455;37;41;14
1228;1;1;2;2;4;57.5;36;44;3
1229;2;5;0;1;1;1;37;37;1
1230;1;1;0;4;4;1;37;37;1
1231;2;3;28;32;60;74.8648648648649;37;75;29
1232;2;1;0;2;2;1;36;36;1
1233;1;5;4;1;5;86.8333333333333;22;41;5
1234;1;1;11;10;21;68;37;39;12
1235;1;1;8;5;13;119.904761904762;37;43;9
1236;2;1;76;23;99;76.5221518987342;28;42;77
1237;1;1;13;12;25;76.4285714285714;36;60;14
1238;2;2;9;11;20;231.733333333333;37;80;10
1239;1;2;2;3;5;28.3333333333333;34;37;3
1240;1;2;3;2;5;149;37;37;4
1241;1;1;4;7;11;91.4166666666667;36;43;5
1242;1;3;1;1;2;12;36;36;2
1243;1;2;1;2;3;18.6666666666667;37;37;2
1244;2;2;13;26;39;123.636363636364;37;50;14
1245;2;2;1;1;2;42;37;37;2
1246;1;3;28;32;60;154.738317757009;37;42;29
1247;2;4;2;3;5;27.6666666666667;37;40;3
1248;2;2;23;23;46;87.5789473684211;37;39;24
1249;2;2;2;3;5;38;37;37;3
1250;1;2;0;1;1;1;37;37;1
1251;2;1;0;5;5;1;37;37;1
1252;1;6;4;7;11;372.352941176471;37;46;5
1253;2;2;37;30;67;216.705882352941;37;76;38
1254;1;4;1;2;3;58.5;37;37;2
1255;2;3;54;63;117;68.3282051282051;37;61;55
1256;2;2;6;7;13;24.9166666666667;37;37;7
1257;2;2;0;1;1;1;37;37;1
1258;1;2;1;1;2;9.5;36;36;2
1259;1;3;1;1;2;17;37;37;2
1260;2;1;16;33;49;113.391304347826;35;43;17
1261;2;3;1;5;6;172;37;37;2
1262;1;2;4;7;11;190.333333333333;38;43;5
1263;1;3;1;1;2;28;36;36;2
1264;1;1;3;3;6;14.2;12;39;4
1265;1;3;2;5;7;29.8;38;52;3
1266;1;1;0;1;1;1;37;37;1
1267;1;3;3;2;5;56.4615384615385;36;42;4
1268;2;2;8;7;15;145.307692307692;38;41;9
1269;1;2;43;20;63;46.7868852459016;28;44;44
1270;1;1;9;12;21;79.9411764705882;38;57;10
1271;1;3;6;7;13;97.6666666666667;37;41;7
1272;1;6;21;10;31;43.2666666666667;38;44;22
1273;1;2;2;4;6;32.3333333333333;38;38;3
1274;1;3;6;7;13;334.88;38;43;7
1275;1;1;0;1;1;1;37;37;1
1276;2;1;0;2;2;1;38;38;1
1277;1;2;0;1;1;1;32;32;1
1278;1;1;0;1;1;1;38;38;1
1279;2;2;4;8;12;86.6666666666667;38;39;5
1280;2;2;46;44;90;158.458823529412;38;80;47
1281;2;2;100;64;164;72.9934640522876;38;43;101
1282;2;3;10;10;20;186.333333333333;37;85;11
1283;1;2;125;96;221;40.0483870967742;38;41;126
1284;2;1;25;28;53;61.0714285714286;38;42;26
1285;1;2;43;35;78;185.909722222222;38;84;44
1286;2;3;8;3;11;25.8333333333333;38;41;9
1287;1;2;7;11;18;96.6153846153846;38;43;8
1288;1;2;1;1;2;4;38;38;2
1289;1;1;3;6;9;61.8;38;56;4
1290;1;1;5;2;7;55.7857142857143;38;40;6
1291;2;2;10;12;22;65.24;38;46;11
1292;1;2;7;6;13;81.75;36;43;8
1293;1;4;0;1;1;1;38;38;1
1294;2;3;2;7;9;61;38;41;3
1295;2;1;7;9;16;120.807692307692;38;43;8
1296;2;1;0;7;7;1;38;38;1
1297;1;3;10;10;20;61.6666666666667;39;55;11
1298;2;2;4;5;9;135.25;37;39;5
1299;2;4;1;11;12;18.75;39;39;2
1300;2;1;1;1;2;61;39;39;2
1301;2;1;0;2;2;1;29;29;1
1302;2;1;13;21;34;58.7931034482759;39;41;14
1303;1;3;1;1;2;28.5;9;9;2
1304;2;2;3;6;9;302.714285714286;39;61;4
1305;1;1;1;1;2;1.5;28;28;2
1306;1;4;3;3;6;94.625;39;39;4
1307;1;2;0;1;1;1;38;38;1
1308;2;4;6;9;15;115.48;38;100;7
1309;1;2;0;1;1;1;36;36;1
1310;1;4;9;12;21;417.235294117647;39;41;10
1311;1;4;1;1;2;2;39;39;2
1312;2;2;26;26;52;60.9760956175299;39;58;27
1313;2;4;25;26;51;169.822485207101;39;86;26
1314;1;2;3;4;7;211.97619047619;39;51;4
1315;1;1;4;5;9;278.333333333333;39;40;5
1316;2;1;7;8;15;47.4615384615385;39;97;8
1317;1;1;15;18;33;69.4230769230769;37;43;16
1318;1;2;0;1;1;1;38;38;1
1319;1;3;5;4;9;137.857142857143;37;50;6
1320;1;2;2;2;4;27.6666666666667;31;40;3
1321;2;1;2;3;5;142.75;39;41;3
1322;2;3;0;2;2;1;39;39;1
1323;1;2;3;5;8;100.571428571429;39;40;4
1324;2;1;0;2;2;1;40;40;1
1325;1;2;8;8;16;54.5;39;41;9
1326;1;2;17;15;32;68.6451612903226;36;43;18
1327;1;5;2;1;3;51.75;6;40;3
1328;1;1;14;6;20;69.0357142857143;39;44;15
1329;1;4;6;11;17;42.4666666666667;40;56;7
1330;1;1;0;1;1;1;37;37;1
1331;1;1;3;0;3;32.25;40;41;4
1332;1;2;34;25;59;60.6282051282051;40;129;35
1333;1;2;1;0;1;65;9;9;2
1334;2;2;3;4;7;29;40;40;4
1335;1;2;7;13;20;35.9090909090909;40;44;8
1336;2;1;1;5;6;26;40;40;2
1337;2;3;0;2;2;1;40;40;1
1338;2;2;29;26;55;63.0421052631579;40;48;30
1339;1;3;40;32;72;87.0155440414508;40;49;41
1340;1;2;12;15;27;48.6086956521739;22;44;13
1341;1;4;0;1;1;1;39;39;1
1342;2;2;8;15;23;240.076923076923;41;86;9
1343;2;3;28;27;55;181.073333333333;41;80;29
1344;2;3;16;17;33;91.8780487804878;37;117;17
1345;1;2;0;1;1;1;19;19;1
1346;2;2;26;35;61;136.72;41;85;27
1347;1;1;0;1;1;1;41;41;1
1348;1;1;0;2;2;1;39;39;1
1349;1;3;9;15;24;43.1724137931034;41;45;10
1350;2;1;3;8;11;44.6153846153846;41;41;4
1351;2;1;0;3;3;1;41;41;1
1352;1;1;3;5;8;175;41;41;4
1353;2;3;2;5;7;49.3333333333333;40;42;3
1354;1;4;5;7;12;47;41;43;6
1355;1;4;3;4;7;17;41;59;4
1356;1;3;7;9;16;75.0769230769231;41;47;8
1357;1;5;0;1;1;1;41;41;1
1358;1;2;13;3;16;36.2272727272727;41;42;14
1359;2;2;13;15;28;56.0322580645161;41;43;14
1360;1;1;0;1;1;1;35;35;1
1361;1;3;1;2;3;12;41;41;2
1362;2;3;14;19;33;241.129032258065;38;109;15
1363;2;1;0;4;4;1;41;41;1
1364;1;3;3;3;6;98.5714285714286;41;42;4
1365;2;1;13;16;29;188.4;41;53;14
1366;1;2;0;1;1;1;40;40;1
1367;1;1;5;6;11;67.2727272727273;41;43;6
1368;1;2;3;2;5;72.5;13;51;4
1369;1;1;2;2;4;17;13;44;3
1370;1;2;2;2;4;33;41;42;3
1371;1;1;1;3;4;15;42;42;2
1372;2;2;0;8;8;1;42;42;1
1373;1;2;25;16;41;68.3673469387755;12;43;26
1374;1;2;1;5;6;28.6666666666667;42;42;2
1375;2;1;11;6;17;86.1470588235294;41;45;12
1376;2;2;1;5;6;12;42;42;2
1377;1;2;4;10;14;26.8333333333333;42;44;5
1378;1;1;2;3;5;94.5;42;55;3
1379;1;2;13;13;26;53.6153846153846;38;44;14
1380;2;4;1;4;5;92;25;25;2
1381;1;2;17;17;34;57.311320754717;42;43;18
1382;1;1;2;2;4;43;41;42;3
1383;1;1;14;11;25;69.0224719101124;41;51;15
1384;2;1;3;9;12;45.6;42;42;4
1385;2;2;0;3;3;1;42;42;1
1386;2;1;2;4;6;55;42;42;3
1387;2;3;17;14;31;50.5176470588235;42;57;18
1388;1;2;0;1;1;1;42;42;1
1389;1;3;0;1;1;1;42;42;1
1390;2;1;0;2;2;1;42;42;1
1391;2;2;1;5;6;64.3333333333333;41;41;2
1392;2;1;0;2;2;1;42;42;1
1393;2;1;13;11;24;168.463414634146;42;47;14
1394;2;3;0;2;2;1;42;42;1
1395;2;2;13;15;28;206.030303030303;42;105;14
1396;1;2;3;1;4;30.5;42;54;4
1397;1;1;9;9;18;77.5;12;92;10
1398;1;2;4;4;8;110.545454545455;37;44;5
1399;1;2;3;2;5;13.6666666666667;42;42;4
1400;2;3;4;4;8;72;42;42;5
1401;1;3;4;5;9;62.5555555555556;42;47;5
1402;2;1;59;59;118;38.0440251572327;42;44;60
1403;1;1;15;17;32;324.820512820513;42;56;16
1404;1;2;2;0;2;19.75;32;42;3
1405;2;1;2;1;3;24.25;40;42;3
1406;1;2;34;24;58;85.0555555555556;42;59;35
1407;2;1;1;2;3;180;42;42;2
1408;1;2;4;6;10;135.818181818182;42;75;5
1409;1;3;4;4;8;199.5;42;45;5
1410;1;1;2;2;4;59.6;42;43;3
1411;1;3;0;1;1;1;21;21;1
1412;2;1;4;10;14;101.142857142857;43;45;5
1413;1;3;16;17;33;166.567567567568;42;61;17
1414;1;4;1;2;3;17;42;42;2
1415;1;2;6;8;14;283.666666666667;43;47;7
1416;1;1;12;3;15;120.55;41;44;13
1417;2;1;4;17;21;83.2;43;47;5
1418;2;4;0;1;1;1;42;42;1
1419;2;3;1;8;9;29;43;43;2
1420;2;1;3;11;14;64;43;43;4
1421;2;1;7;12;19;47.875;43;45;8
1422;1;1;2;2;4;175.8;38;43;3
1423;1;1;10;13;23;227.794871794872;43;49;11
1424;1;1;4;5;9;12.6666666666667;43;43;5
1425;1;2;6;7;13;105.166666666667;43;44;7
1426;2;1;5;11;16;46.125;43;56;6
1427;1;2;2;4;6;23.3333333333333;43;43;3
1428;2;3;0;1;1;1;43;43;1
1429;1;2;2;2;4;11.3333333333333;42;43;3
1430;2;3;0;3;3;1;43;43;1
1431;2;3;4;5;9;200;43;50;5
1432;1;2;0;1;1;1;43;43;1
1433;1;2;10;8;18;104.083333333333;43;44;11
1434;2;3;30;19;49;89.1379310344828;43;79;31
1435;2;4;2;3;5;116.5;43;43;3
1436;2;4;16;18;34;59.5897435897436;43;120;17
1437;2;2;3;3;6;30;43;49;4
1438;1;1;5;4;9;121.647058823529;43;44;6
1439;1;5;1;0;1;5.5;44;44;2
1440;1;2;18;18;36;90.4411764705882;43;57;19
1441;1;2;3;4;7;65.7692307692308;44;44;4
1442;1;3;2;2;4;51;43;44;3
1443;2;2;2;3;5;37.5;44;44;3
1444;2;2;6;10;16;52.2941176470588;44;46;7
1445;2;1;0;4;4;1;43;43;1
1446;1;2;1;2;3;4;44;44;2
1447;1;2;3;4;7;92.8333333333333;43;50;4
1448;1;1;0;3;3;1;42;42;1
1449;1;2;7;20;27;38.125;44;46;8
1450;2;3;0;1;1;1;44;44;1
1451;2;1;0;2;2;1;43;43;1
1452;2;1;3;4;7;105.166666666667;43;156;4
1453;2;2;0;5;5;1;43;43;1
1454;1;2;1;3;4;25.3333333333333;44;44;2
1455;2;4;0;1;1;1;37;37;1
1456;2;1;0;1;1;1;42;42;1
1457;2;2;0;1;1;1;9;9;1
1458;2;1;0;1;1;1;22;22;1
1459;2;2;0;1;1;1;19;19;1
1460;2;1;0;1;1;1;20;20;1
1461;1;1;1;3;4;19.5;44;44;2
1462;1;2;0;1;1;1;44;44;1
1463;2;1;10;11;21;30.6190476190476;44;44;11
1464;2;3;0;1;1;1;41;41;1
1465;2;1;0;1;1;1;29;29;1
1466;2;1;0;2;2;1;28;28;1
1467;2;2;2;5;7;169;44;91;3
1468;2;1;7;7;14;69;44;62;8
1469;1;1;0;1;1;1;44;44;1
1470;2;3;0;4;4;1;44;44;1
1471;2;2;0;1;1;1;41;41;1
1472;1;2;19;20;39;218.15;43;113;20
1473;2;2;0;1;1;1;15;15;1
1474;1;2;5;5;10;23.5555555555556;44;60;6
1475;2;3;2;2;4;68;44;52;3
1476;1;1;2;2;4;94.2;44;44;3
1477;2;2;0;1;1;1;42;42;1
1478;2;2;0;3;3;1;44;44;1
1479;1;2;2;3;5;132;8;45;3
1480;1;1;2;3;5;73;44;45;3
1481;1;2;0;1;1;1;40;40;1
1482;2;3;0;2;2;1;45;45;1
1483;2;1;0;1;1;1;45;45;1
1484;2;1;0;1;1;1;45;45;1
1485;2;1;4;11;15;96.875;44;60;5
1486;1;2;1;1;2;19;31;31;2
1487;2;3;19;17;36;207.078947368421;45;89;20
1488;2;3;18;9;27;102.860465116279;43;179;19
1489;2;2;22;19;41;77.6619718309859;44;51;23
1490;1;4;1;1;2;5;42;42;2
1491;2;2;4;8;12;140.555555555556;46;77;5
1492;2;1;1;2;3;91;46;46;2
1493;2;2;9;10;19;91.8372093023256;45;60;10
1494;1;2;0;2;2;1;45;45;1
1495;1;2;0;1;1;1;46;46;1
1496;2;2;2;6;8;65.2;46;46;3
1497;2;1;3;20;23;64.9;46;52;4
1498;1;2;0;1;1;1;45;45;1
1499;1;1;0;1;1;1;46;46;1
1500;1;4;5;6;11;710.846153846154;46;56;6
1501;1;4;1;5;6;59.6666666666667;46;46;2
1502;1;2;5;3;8;19.8181818181818;46;48;6
1503;1;4;1;2;3;18.5;46;46;2
1504;2;4;1;2;3;22.5;7;7;2
1505;2;3;0;7;7;1;46;46;1
1506;2;4;0;1;1;1;47;47;1
1507;2;1;8;7;15;101.25;47;49;9
1508;1;1;10;10;20;104.090909090909;47;48;11
1509;2;4;23;14;37;105.657142857143;47;83;24
1510;2;3;4;9;13;119.5;47;50;5
1511;2;1;0;2;2;1;47;47;1
1512;2;4;0;1;1;1;47;47;1
1513;1;2;5;7;12;64.2;47;67;6
1514;1;3;3;4;7;120.25;48;48;4
1515;1;1;0;2;2;1;47;47;1
1516;1;1;1;2;3;132.5;47;47;2
1517;1;4;14;17;31;90.1818181818182;48;112;15
1518;2;5;4;7;11;23.2;45;51;5
1519;2;1;0;1;1;1;48;48;1
1520;1;3;19;12;31;68.4098360655738;47;60;20
1521;1;2;9;5;14;39.9047619047619;48;51;10
1522;1;2;17;11;28;98.575;48;56;18
1523;1;3;3;2;5;197.666666666667;48;48;4
1524;2;6;0;1;1;1;46;46;1
1525;1;3;0;2;2;1;48;48;1
1526;1;2;2;12;14;14.6666666666667;48;48;3
1527;1;2;1;1;2;26.5;48;48;2
1528;2;4;1;2;3;140;48;48;2
1529;1;2;0;2;2;1;47;47;1
1530;1;1;1;1;2;138;48;48;2
1531;1;6;0;1;1;1;48;48;1
1532;1;3;1;0;1;17;49;49;2
1533;1;1;2;1;3;253.75;7;49;3
1534;2;1;2;3;5;59;49;49;3
1535;2;4;6;4;10;74.875;48;92;7
1536;1;1;0;1;1;1;49;49;1
1537;1;4;2;2;4;94;45;55;3
1538;1;4;0;2;2;1;49;49;1
1539;1;2;65;15;80;42.9112426035503;49;55;66
1540;2;2;35;29;64;175.670886075949;49;83;36
1541;2;3;0;3;3;1;49;49;1
1542;1;3;13;14;27;173.478260869565;47;127;14
1543;1;4;98;41;139;446.402843601896;49;128;99
1544;1;4;0;1;1;1;15;15;1
1545;1;3;14;9;23;34.2545454545455;49;57;15
1546;2;4;14;14;28;60.9375;49;61;15
1547;2;3;0;2;2;1;49;49;1
1548;2;2;8;8;16;184.76;49;79;9
1549;1;1;0;1;1;1;49;49;1
1550;1;3;1;2;3;6;49;49;2
1551;1;2;4;5;9;31.2857142857143;50;51;5
1552;1;3;2;1;3;8.25;50;50;3
1553;2;3;2;4;6;28;50;50;3
1554;2;3;9;9;18;64.4242424242424;50;61;10
1555;2;1;2;2;4;22.6666666666667;49;60;3
1556;1;3;20;8;28;20.156862745098;50;51;21
1557;1;4;6;9;15;22.1818181818182;31;190;7
1558;1;2;0;3;3;1;50;50;1
1559;1;1;0;1;1;1;49;49;1
1560;1;1;0;1;1;1;49;49;1
1561;1;1;3;4;7;36.75;49;58;4
1562;1;4;17;8;25;129.166666666667;50;80;18
1563;2;1;0;2;2;1;50;50;1
1564;1;2;3;1;4;63.4;6;50;4
1565;2;5;26;36;62;92.5402298850575;31;75;27
1566;2;3;1;4;5;22;43;43;2
1567;2;4;0;1;1;1;45;45;1
1568;2;2;10;15;25;119.409090909091;50;61;11
1569;1;1;1;1;2;34;9;9;2
1570;1;3;1;1;2;17.5;50;50;2
1571;1;5;0;1;1;1;50;50;1
1572;2;2;2;2;4;36.6666666666667;49;50;3
1573;2;4;5;16;21;52.1111111111111;50;50;6
1574;1;2;0;1;1;1;17;17;1
1575;1;4;3;3;6;877.454545454545;50;50;4
1576;1;3;9;6;15;79.2307692307692;48;54;10
1577;1;3;3;5;8;129;50;52;4
1578;2;1;5;6;11;138.777777777778;50;51;6
1579;2;2;9;6;15;81.2777777777778;49;51;10
1580;2;1;19;19;38;81.9852941176471;50;59;20
1581;1;1;0;1;1;1;46;46;1
1582;2;1;7;11;18;109.583333333333;50;52;8
1583;1;3;1;2;3;59.5;49;49;2
1584;2;1;1;1;2;44.5;50;50;2
1585;2;2;25;34;59;131.25;50;119;26
1586;1;4;5;3;8;67.6666666666667;50;51;6
1587;2;1;2;12;14;58;45;51;3
1588;1;2;4;4;8;78.5;50;51;5
1589;1;1;0;1;1;1;50;50;1
1590;1;1;1;0;1;29;46;46;2
1591;1;4;0;2;2;1;50;50;1
1592;1;3;1;2;3;177;16;16;2
1593;1;1;0;1;1;1;40;40;1
1594;1;1;6;5;11;116;50;52;7
1595;1;2;0;1;1;1;51;51;1
1596;2;1;2;0;2;8.66666666666667;49;51;3
1597;1;4;0;3;3;1;51;51;1
1598;2;1;90;18;108;51.1165644171779;51;51;91
1599;2;1;0;1;1;1;51;51;1
1600;2;3;0;1;1;1;51;51;1
1601;1;3;43;23;66;147.322916666667;51;162;44
1602;1;2;2;1;3;10.6666666666667;38;58;3
1603;2;4;10;20;30;63.3157894736842;51;57;11
1604;1;4;0;1;1;1;17;17;1
1605;1;2;1;2;3;14;52;52;2
1606;1;1;2;1;3;23.3333333333333;51;52;3
1607;1;2;0;1;1;1;51;51;1
1608;2;4;4;7;11;88.2;51;57;5
1609;2;4;0;1;1;1;52;52;1
1610;2;4;0;1;1;1;49;49;1
1611;2;4;1;1;2;15.5;51;51;2
1612;1;4;0;1;1;1;15;15;1
1613;1;3;0;1;1;1;28;28;1
1614;1;1;1;0;1;12.5;37;37;2
1615;1;1;0;1;1;1;7;7;1
1616;2;3;12;19;31;272.444444444444;52;55;13
1617;1;1;2;2;4;52.3333333333333;50;56;3
1618;2;1;0;5;5;1;53;53;1
1619;1;2;21;11;32;135.45;53;56;22
1620;2;2;0;2;2;1;53;53;1
1621;2;2;2;3;5;48;53;57;3
1622;2;1;0;4;4;1;53;53;1
1623;1;1;3;4;7;145.090909090909;53;55;4
1624;2;4;87;74;161;52.9095163806552;53;156;88
1625;1;2;2;2;4;40.6666666666667;30;54;3
1626;1;4;4;6;10;107.636363636364;53;97;5
1627;1;4;1;3;4;4.5;40;40;2
1628;2;1;0;1;1;1;42;42;1
1629;2;2;7;10;17;109.714285714286;54;151;8
1630;1;2;2;2;4;8;52;55;3
1631;1;6;0;1;1;1;39;39;1
1632;1;1;1;2;3;95.25;54;54;2
1633;1;5;0;2;2;1;54;54;1
1634;1;1;0;1;1;1;54;54;1
1635;1;2;0;2;2;1;9;9;1
1636;1;4;2;5;7;69;54;57;3
1637;2;2;2;5;7;18.3333333333333;55;55;3
1638;1;4;4;1;5;27.1666666666667;55;56;5
1639;2;3;2;4;6;71.6666666666667;55;58;3
1640;2;3;0;2;2;1;55;55;1
1641;2;1;8;14;22;106.722222222222;54;56;9
1642;2;3;9;8;17;82.3823529411765;55;57;10
1643;2;1;0;2;2;1;55;55;1
1644;2;3;42;41;83;167.935483870968;55;105;43
1645;2;4;0;3;3;1;55;55;1
1646;2;2;4;9;13;31.25;55;55;5
1647;2;3;36;31;67;102.581560283688;55;80;37
1648;2;2;20;17;37;116.481481481481;55;57;21
1649;2;1;1;6;7;12.5;55;55;2
1650;2;3;0;1;1;1;55;55;1
1651;1;1;0;1;1;1;56;56;1
1652;2;2;1;3;4;44;55;55;2
1653;1;5;2;2;4;43.6666666666667;26;56;3
1654;1;4;0;1;1;1;43;43;1
1655;2;2;11;15;26;35.3333333333333;56;91;12
1656;1;3;2;3;5;267.75;50;57;3
1657;1;1;20;14;34;36.2058823529412;56;77;21
1658;1;3;2;0;2;31.3333333333333;56;57;3
1659;1;4;0;1;1;1;28;28;1
1660;1;1;0;1;1;1;56;56;1
1661;1;1;2;1;3;32.5;56;57;3
1662;1;3;0;2;2;1;45;45;1
1663;1;4;1;1;2;5;57;57;2
1664;2;1;0;1;1;1;57;57;1
1665;2;1;14;21;35;90.46875;57;57;15
1666;1;4;0;1;1;1;56;56;1
1667;1;4;31;17;48;45.0126582278481;57;87;32
1668;1;2;5;6;11;67.8333333333333;58;58;6
1669;1;4;24;13;37;171.518518518519;57;90;25
1670;2;1;1;1;2;3.5;58;58;2
1671;1;1;1;1;2;83;57;57;2
1672;1;1;1;0;1;93;58;58;2
1673;2;3;5;6;11;22.5714285714286;58;84;6
1674;1;1;0;1;1;1;58;58;1
1675;2;3;14;12;26;260.150943396226;49;138;15
1676;1;2;7;9;16;111.8;38;145;8
1677;1;2;2;1;3;41.6;58;59;3
1678;1;3;7;6;13;82.7777777777778;58;101;8
1679;1;3;3;4;7;177.722222222222;49;58;4
1680;1;1;1;3;4;67;58;58;2
1681;1;3;3;5;8;344.333333333333;58;61;4
1682;2;2;0;2;2;1;59;59;1
1683;2;4;0;2;2;1;58;58;1
1684;2;1;0;1;1;1;40;40;1
1685;1;1;0;1;1;1;59;59;1
1686;1;3;17;13;30;73.5128205128205;59;128;18
1687;2;4;0;1;1;1;16;16;1
1688;1;2;6;6;12;113.882352941176;56;60;7
1689;2;2;0;3;3;1;59;59;1
1690;2;4;3;3;6;38.625;58;60;4
1691;1;3;0;1;1;1;56;56;1
1692;2;4;0;3;3;1;60;60;1
1693;1;3;0;1;1;1;60;60;1
1694;1;3;3;3;6;17;60;62;4
1695;1;2;0;1;1;1;40;40;1
1696;2;1;0;1;1;1;57;57;1
1697;1;3;0;1;1;1;55;55;1
1698;1;2;2;4;6;40;61;101;3
1699;2;2;0;3;3;1;57;57;1
1700;1;3;6;5;11;91.6875;62;153;7
1701;2;1;0;6;6;1;62;62;1
1702;2;1;0;1;1;1;59;59;1
1703;1;4;0;1;1;1;9;9;1
1704;1;4;2;1;3;79.6666666666667;62;63;3
1705;1;1;0;1;1;1;12;12;1
1706;2;3;0;2;2;1;61;61;1
1707;1;3;0;1;1;1;40;40;1
1708;2;2;0;1;1;1;64;64;1
1709;1;2;0;1;1;1;52;52;1
1710;2;3;0;1;1;1;65;65;1
1711;1;3;0;1;1;1;36;36;1
1712;2;2;3;2;5;41.2;68;76;4
1713;1;5;108;74;182;48.9485861182519;71;84;109
1714;2;3;0;1;1;1;41;41;1
1715;2;3;0;3;3;1;71;71;1
1716;1;5;6;5;11;86.8666666666667;56;111;7
1717;1;2;7;5;12;79.7777777777778;72;76;8
1718;2;1;0;1;1;1;66;66;1
1719;2;2;0;2;2;1;72;72;1
1720;2;2;2;2;4;27.3333333333333;69;75;3
1721;1;2;1;1;2;83.6666666666667;17;17;2
1722;2;5;0;1;1;1;43;43;1
1723;2;2;1;1;2;6.5;75;75;2
1724;2;2;22;22;44;121.808823529412;19;152;23
1725;1;3;3;3;6;46.6;64;77;4
1726;2;1;0;1;1;1;41;41;1
1727;1;2;15;6;21;108.416666666667;68;87;16
1728;2;3;2;4;6;156;77;77;3
1729;1;2;0;1;1;1;10;10;1
1730;2;2;11;10;21;132.727272727273;69;133;12
1731;2;1;3;8;11;34.4;64;97;4
1732;2;3;2;2;4;50.3333333333333;76;78;3
1733;2;2;1;1;2;15;60;60;2
1734;1;2;2;3;5;67.3333333333333;80;80;3
1735;1;1;0;1;1;1;78;78;1
1736;1;4;2;1;3;6.66666666666667;58;81;3
1737;1;5;12;8;20;49.3333333333333;80;84;13
1738;1;2;4;6;10;176.3;82;83;5
1739;2;1;3;6;9;33;82;82;4
1740;2;1;1;1;2;123.333333333333;54;54;2
1741;1;6;30;7;37;131.684210526316;8;125;31
1742;2;5;1;8;9;110;86;86;2
1743;2;3;0;2;2;1;84;84;1
1744;1;4;4;5;9;211.5;85;89;5
1745;2;2;0;2;2;1;86;86;1
1746;1;2;3;4;7;23.75;87;87;4
1747;2;1;0;1;1;1;87;87;1
1748;2;2;14;15;29;78.5405405405405;46;108;15
1749;2;3;7;12;19;83.4545454545455;87;90;8
1750;1;3;11;8;19;196.382352941176;87;126;12
1751;1;6;0;1;1;1;37;37;1
1752;1;1;2;3;5;111.333333333333;88;91;3
1753;2;2;0;2;2;1;75;75;1
1754;1;3;1;2;3;58.4;62;62;2
1755;2;2;1;1;2;34.5;16;16;2
1756;1;1;31;23;54;160.08875739645;7;128;32
1757;1;4;0;1;1;1;62;62;1
1758;1;3;6;5;11;262.5;92;110;7
1759;2;2;0;1;1;1;71;71;1
1760;2;3;0;2;2;1;89;89;1
1761;1;1;0;1;1;1;98;98;1
1762;1;2;4;3;7;129.423076923077;98;99;5
1763;1;4;1;2;3;12.6666666666667;99;99;2
1764;2;2;0;1;1;1;8;8;1
1765;2;2;2;2;4;282;98;103;3
1766;1;2;0;1;1;1;82;82;1
1767;2;3;0;2;2;1;99;99;1
1768;2;4;0;4;4;1;98;98;1
1769;2;4;0;1;1;1;93;93;1
1770;2;2;0;1;1;1;103;103;1
1771;1;3;11;10;21;95.7307692307692;89;122;12
1772;1;1;3;3;6;467.727272727273;98;114;4
1773;1;3;4;4;8;120.666666666667;106;108;5
1774;1;1;0;1;1;1;64;64;1
1775;2;4;5;5;10;16.75;105;108;6
1776;2;2;0;1;1;1;107;107;1
1777;2;1;0;1;1;1;105;105;1
1778;1;1;1;1;2;151.5;107;107;2
1779;2;2;0;1;1;1;63;63;1
1780;1;2;1;0;1;126.5;105;105;2
1781;2;4;16;16;32;51.4722222222222;111;155;17
1782;1;3;0;1;1;1;112;112;1
1783;1;1;33;24;57;45.3513513513514;112;152;34
1784;1;5;1;1;2;38.2727272727273;112;112;2
1785;1;2;2;1;3;31;13;114;3
1786;1;5;13;8;21;59.4814814814815;115;120;14
1787;1;1;0;1;1;1;47;47;1
1788;2;4;1;5;6;36;118;118;2
1789;2;3;11;11;22;71.3846153846154;118;140;12
1790;1;2;0;1;1;1;115;115;1
1791;1;5;3;2;5;149.25;118;153;4
1792;2;3;16;18;34;222.65625;120;121;17
1793;1;2;1;2;3;48;29;29;2
1794;2;3;0;1;1;1;64;64;1
1795;1;5;0;1;1;1;115;115;1
1796;2;1;13;18;31;470;124;128;14
1797;1;2;1;1;2;10;125;125;2
1798;2;1;1;1;2;21;21;21;2
1799;1;1;2;2;4;158;125;125;3
1800;1;6;2;2;4;280;122;152;3
1801;2;1;2;2;4;119.666666666667;127;127;3
1802;1;1;1;1;2;99.5;112;112;2
1803;2;1;0;1;1;1;119;119;1
1804;1;5;1;1;2;212.666666666667;118;118;2
1805;1;4;0;1;1;1;128;128;1
1806;2;4;0;2;2;1;128;128;1
1807;2;3;4;4;8;26.1111111111111;132;132;5
1808;2;1;3;5;8;436.545454545455;132;137;4
1809;1;2;0;2;2;1;42;42;1
1810;1;2;0;1;1;1;133;133;1
1811;1;1;3;3;6;131.75;122;135;4
1812;1;4;1;0;1;1.5;134;134;2
1813;2;1;0;1;1;1;110;110;1
1814;1;5;4;3;7;97.5714285714286;135;137;5
1815;1;1;1;1;2;17.5;122;122;2
1816;1;2;0;1;1;1;136;136;1
1817;1;4;0;1;1;1;37;37;1
1818;1;4;0;1;1;1;117;117;1
1819;1;4;0;1;1;1;129;129;1
1820;1;4;0;1;1;1;9;9;1
1821;1;3;0;1;1;1;51;51;1
1822;1;3;0;1;1;1;43;43;1
1823;1;3;0;1;1;1;44;44;1
1824;1;3;0;1;1;1;60;60;1
1825;1;3;0;1;1;1;44;44;1
1826;1;4;0;1;1;1;16;16;1
1827;1;3;0;1;1;1;52;52;1
1828;2;3;0;1;1;1;133;133;1
1829;1;2;0;1;1;1;139;139;1
1830;2;1;0;1;1;1;61;61;1
1831;2;1;7;8;15;173.818181818182;142;147;8
1832;2;5;0;1;1;1;139;139;1
1833;1;1;0;1;1;1;150;150;1
1834;1;1;0;1;1;1;45;45;1
1835;2;1;0;1;1;1;150;150;1
1836;1;2;17;8;25;515.651162790698;151;155;18
1837;2;1;0;2;2;1;149;149;1
1838;2;1;0;1;1;1;152;152;1
1839;2;1;7;9;16;69.125;152;155;8
1840;2;5;0;2;2;1;130;130;1
1841;1;2;0;1;1;1;130;130;1
1842;2;2;0;1;1;1;144;144;1
1843;2;1;0;2;2;1;158;158;1
1844;1;3;3;0;3;138.5;158;158;4
1845;2;1;0;2;2;1;158;158;1
1846;1;1;0;1;1;1;159;159;1
1847;2;4;0;5;5;1;158;158;1
1848;2;1;2;3;5;179.2;158;160;3
1849;2;4;0;1;1;1;159;159;1
1850;1;4;0;1;1;1;159;159;1
1851;1;2;0;1;1;1;158;158;1
1852;1;3;6;6;12;113.769230769231;159;162;7
1853;2;1;0;1;1;1;159;159;1
1854;2;3;1;1;2;1.5;160;160;2
1855;2;1;0;1;1;1;161;161;1
1856;2;3;0;1;1;1;162;162;1
1857;2;2;0;1;1;1;161;161;1
1858;2;2;0;1;1;1;162;162;1
1859;2;1;3;3;6;52.8125;163;163;4
1860;2;4;3;2;5;59.4;163;164;4
1861;2;1;0;1;1;1;162;162;1
1862;1;4;3;3;6;46;153;165;4
1863;2;1;0;1;1;1;161;161;1
1864;1;3;3;3;6;208.5;160;173;4
1865;2;1;3;9;12;229;164;170;4
1866;1;3;9;6;15;46.2033898305085;163;175;10
1867;1;4;0;1;1;1;92;92;1
1868;1;3;8;7;15;57.65;161;166;9
1869;1;4;1;1;2;18;159;159;2
1870;2;3;1;2;3;47;165;165;2
1871;1;5;1;1;2;46;166;166;2
1872;2;3;2;3;5;44.25;166;166;3
1873;1;4;0;1;1;1;162;162;1
1874;1;3;1;0;1;15;168;168;2
1875;2;4;1;3;4;61.5;168;168;2
1876;1;2;8;3;11;174.875;161;175;9
1877;2;4;0;2;2;1;169;169;1
1878;1;3;9;5;14;119.631578947368;170;181;10
1879;2;4;2;3;5;151.333333333333;67;189;3
1880;2;5;0;1;1;1;157;157;1
1881;2;3;5;5;10;42.3333333333333;170;176;6
1882;2;2;0;2;2;1;57;57;1
1883;1;3;0;1;1;1;178;178;1
1884;2;4;0;1;1;1;179;179;1
1885;2;1;0;1;1;1;172;172;1
1886;2;3;0;1;1;1;170;170;1
1887;2;3;0;1;1;1;169;169;1
1888;2;1;1;1;2;24.75;168;168;2
1889;2;2;0;2;2;1;169;169;1
1890;2;5;0;1;1;1;178;178;1
1891;2;3;0;1;1;1;91;91;1
1892;1;5;1;1;2;358.333333333333;177;177;2
1893;1;4;2;1;3;6;183;183;3
1894;2;2;0;1;1;1;185;185;1
1895;1;3;1;0;1;119.5;169;169;2
1896;1;3;1;0;1;91.5;191;191;2
1897;2;2;1;1;2;10.5;191;191;2
1898;2;3;1;1;2;6.5;192;192;2
1899;1;5;26;0;26;135.851851851852;194;196;27
